30 100
CTTAAATTGGAAATTGGGCGTAGCGGCTAT|TCAGGGCTAGATACTTAGATTCTTAAATTG
GATACTTAGATTCTTAAATTGGAGTCCTGT|TCTGCAGGGCTAGATACTTAGATTCTTAAA
CATTGCACGAGTAGGATACCATGACAGAAG|ATACTTAGATTCTTAAATTGGATTGCTAAG
TTGGCCCAACACAGTAAATGAGCTAAACAT|ATGAAATAGCAGGGCTAGATACTTAGATTC
GGCTAGATACTTAGATTCTTAAATTGGGCG|CACGTCCAAGCTACCTTACTGTGTAGATGA
GGGCTAGATACTTAGATTCTTAAATTGGTA|TAACGTATGCTGAACAGACAGCATCTAAGC
GTGTCTAAGTGGAACCAACACTCCAAAATC|ACGCCTCGGAGTAGCAGGTGCTGCGGTGGG
AATTGGTAGACAGGGCTAGATACTTAGATT|ATCTAAGCGCCGCTCCGCTAATACCAGAAC
TAGATTCTTAAATTGGAATTCTCCCTCAAC|GATACTTAGATTCTTAAATTGGCGCGCTCA
TAATACCAGAACCTCAGGGCTAGATACTTA|TAAATTGGATCGGAAAAGAACACGGCCGTT
GAGGACCAGCGAATAACGAGTCACCCGTGT|CATCGACCGATCGTCGGTGATTCTATACAA
TTAAATTGGTGGAGTATAGGATGCTCAAAG|ACACACATCAGGGCTAGATACTTAGATTCT
ACTTAGATTCTCAGGGCTAGATACTTAGAT|CCGTTGACAGCACCATTGCACGAGTAGGAT
GGCTCCATCGCTCAGGGCTAGATACTTAGA|CAGGAGACGGGCAACTCAGGGGTCTCAGGA
AATTGGAATTCTCCCTCAACTAGGGCTCCA|TTCTTAAATTGGCGCGCTCACTCCAGGAGA
CTCCAGGAAGCCCCCAACGTGACAAGGGGT|AAATTGGAATTCTCCCTCAACTAGGGCTCC
CATTGGTCCAAGCGCCATTGAGCCGAACTA|GAGTCGCACCTCGAGTTTCCGGCAGACGAA
CACTCCAGGAGACGGGCAACTCAGGGGTCT|CTCAAGTTTCATTGGTCCAAGCGCCATTGA
CAGCCTCTGAGTCGCACCTCGAGTTTCCGG|TCGATAGTAGGCGCTAGAGTGGAGGTCTAC
GTCCACCCCAAGGCAGGGCTAGATACTTAG|CAGAACTGAAGCAGGGCTAGATACTTAGAT
ATTGCGCTGCGGCTCTCCTTGGTGTTCAGC|GGGACGATGACTAGTCACATGGGCCTTTCG
TGCAGGGCTAGATACTTAGATTCTTAAATT|TAGATTCTTAAATTGGCCCAACACAGTAAA
ACAGACAGCATCTAAGCGCCGCTCCGCTAA|ATACTTAGATTCTTAAATTGGGATTCTTAA
AATTTCGGGATTATAGCCAACCAGGGCTAG|TTAAATTGGGCGATAAGTAACAGAGGACCA
GGGCTAGATACTTACAGGGCTAGATACTTA|CTGCGTTCTAGCCATCCACCGTGTCTAAGT
GCCCCCAACGTGACAAGGGGTCCTTACCAG|TTCTCCCTCAACTAGGGCTCCATCGCTCAG
AGACAGCATCTAAGCGCCGCTCCGCTAATA|ACTTAGATTCTTAAATTGGGATTCTTAAAT
AAACATAATTTCGGGATTATAGCCAACCAG|AGATTCTTAAATTGGGCGATAAGTAACAGA
GCCGAACTAGAACTCGTGGGCGCCTCACGT|GCAGACGAACCTATATCACCATTGCGCTGC
CTAGATACTTAGATTCTTAAATTGGGATTC|CGTGTCTAAGTGGAACCAACACTCCAAAAT
AGGGCTAGATACTTAGATTCTTAAATTGGT|TGGCGTTTTACGACGCCGACACACACATCA
TTAGATTCTTAAATTGGATTGCTAAGGTCC|AGATTCTTAAATTGGAGTCCTGTCAGGGCT
ATACTTAGATTCTTAAATTGGGATTCTTAA|TCTAAGTGGAACCAACACTCCAAAATCGCA
AACTCTATGAAATAGCAGGGCTAGATACTT|TAGAACTCGTGGGCGCCTCACGTCCAAGCT
AATTGGTGGAGTATAGGATGCTCAAAGTCT|CACATCAGGGCTAGATACTTAGATTCTTAA
AGGAGACGGGCAACTCAGGGGTCTCAGGAT|TTTCATTGGTCCAAGCGCCATTGAGCCGAA
GATTCTTAAATTGGTAAATTGGGAGGCAGG|GATACCATGACAGAAGTGGATGGTCGGCCT
TAGACAGGGCTAGATACTTAGATTCTTCAG|GCGCCGCTCCGCTAATACCAGAACCTCAGG
GCTAAACATAATTTCGGGATTATAGCCAAC|CTTAGATTCTTAAATTGGGCGATAAGTAAC
TGAAATAGCAGGGCTAGATACTTAGATTCT|CGTGGGCGCCTCACGTCCAAGCTACCTTAC
CATTGCGCTGCGGCTCTCCTTGGTGTTCAG|AGGGACGATGACTAGTCACATGGGCCTTTC
GGCTAGATACTTAGATTCTCAGGGCTAGAT|GAACACGGCCGTTGACAGCACCATTGCACG
TACTTAGATTCTTAAATTGGATTGCTAAGG|CTTAGATTCTTAAATTGGAGTCCTGTCAGG
CACCTCGAGTTTCCGGCAGACGAACCTATA|TAGAGTGGAGGTCTACTGTGTGCGTATCTC
TAAATTGGGATTCTTAAATTGGATCGGAAA|AACACTCCAAAATCGCAGCAGAGTGCTAAC
CTATGAAATAGCAGGGCTAGATACTTAGAT|ACTCGTGGGCGCCTCACGTCCAAGCTACCT
GGGTCTCAGGATCAACTCTATGAAATAGCA|CATTGAGCCGAACTAGAACTCGTGGGCGCC
TAGATTCTTAAATTGGGATTCTTAAATTGG|GTGGAACCAACACTCCAAAATCGCAGCAGA
GCACCATTGCACGAGTAGGATACCATGACA|CTAGATACTTAGATTCTTAAATTGGATTGC
CAGGGCTAGATACTTAGATTCTTAAATTGG|TCCACCGTGTCTAAGTGGAACCAACACTCC
GGCTAGATACTTAGATTCTTAAATTGGAAA|GCTAGATACTTAGATTCTCAGGGCTAGATA
CTCAAAGTCTCCAGGAAGCCCCCAACGTGA|AGATTCTTAAATTGGAATTCTCCCTCAACT
GCTAGATACTTAGATTCTTAAATTGGAAAT|CTAGATACTTAGATTCTCAGGGCTAGATAC
CGCCTCACGTCCAAGCTACCTTACTGTGTA|ATTGCGCTGCGGCTCTCCTTGGTGTTCAGC
ATTGGAATTCTCCCTCAACTAGGGCTCCAT|TCTTAAATTGGCGCGCTCACTCCAGGAGAC
CCCAACACAGTAAATGAGCTAAACATAATT|AATAGCAGGGCTAGATACTTAGATTCTTAA
GACTCACAGGGCTAGATACTTAGATTCTTA|CTCGACCGTAACGTATGCTGAACAGACAGC
TGGAATTCTCCCTCAACTAGGGCTCCATCG|TTAAATTGGCGCGCTCACTCCAGGAGACGG
AGATACTTACAGGGCTAGATACTTAGATTC|TTCTAGCCATCCACCGTGTCTAAGTGGAAC
AGCATCTAAGCGCCGCTCCGCTAATACCAG|AGATTCTTAAATTGGGATTCTTAAATTGGA
GGCAGGGCTAGATACTTAGATTCTTAAATT|CAGGGCTAGATACTTAGATTCTTAAATTGG
CGCAGCAGAGTGCTAACGTCCACCCCAAGG|GCAGCATGCAGCTTACGCAGAACTGAAGCA
GCCAACCAGGGCTAGATACTTAGATTCTTA|AGTAACAGAGGACCAGCGAATAACGAGTCA
CGAGTAGGATACCATGACAGAAGTGGATGG|GATTCTTAAATTGGATTGCTAAGGTCCATG
GGATCAACTCTATGAAATAGCAGGGCTAGA|CGAACTAGAACTCGTGGGCGCCTCACGTCC
GTAGACAGGGCTAGATACTTAGATTCTTCA|AGCGCCGCTCCGCTAATACCAGAACCTCAG
TTCTCAGGGCTAGATACTTAGATTCTTAAA|CAGCACCATTGCACGAGTAGGATACCATGA
TACTGTGTAGATGAGGGTAGCCGCCATCGA|GTGTTCAGCATGGACTCCATTTTCTGGTTG
AATTGGGCGATAAGTAACAGAGGACCAGCG|TGTAGATGAGGGTAGCCGCCATCGACCGAT
CCATCCACCGTGTCTAAGTGGAACCAACAC|TGAGCATTCACGCCTCGGAGTAGCAGGTGC
TAAATTGGCCCAACACAGTAAATGAGCTAA|CTCTATGAAATAGCAGGGCTAGATACTTAG
GGAGGCAGGGCTAGATACTTACAGGGCTAG|GGTCGGCCTGCGTTCTAGCCATCCACCGTG
TAGATACTTAGATTCTTAAATTGGGCGATA|GTCCAAGCTACCTTACTGTGTAGATGAGGG
GGCTAGATACTTAGATTCTTCAGGGCTAGA|TCCGCTAATACCAGAACCTCAGGGCTAGAT
TGTAGATGAGGGTAGCCGCCATCGACCGAT|CAGCATGGACTCCATTTTCTGGTTGAAGTC
AGGGCTAGATACTTAGATTCTTAAATTGGG|CTCACGTCCAAGCTACCTTACTGTGTAGAT
CAGGGCTAGATACTTAGATTCTTAAATTGG|GGGCTAGATACTTAGATTCTTAAATTGGAG
GGAGTCCTGTCAGGGCTAGATACTTAGATT|GATTCTTAAATTGGCGTTTTACGACGCCGA
TCCTGTCAGGGCTAGATACTTAGATTCTTA|CTTAAATTGGCGTTTTACGACGCCGACACA
AGTCCTGTCAGGGCTAGATACTTAGATTCT|TTCTTAAATTGGCGTTTTACGACGCCGACA
CCGTTGACAGCACCATTGCACGAGTAGGAT|AAGGCAGGGCTAGATACTTAGATTCTTAAA
GCAGGGCTAGATACTTAGATTCTTAAATTG|GCCTCACGTCCAAGCTACCTTACTGTGTAG
ACACTCCAAAATCGCAGCAGAGTGCTAACG|GTGCTGCGGTGGGCAGCATGCAGCTTACGC
CCGCTAATACCAGAACCTCAGGGCTAGATA|TTCTTAAATTGGATCGGAAAAGAACACGGC
ATACTTAGATTCTTAAATTGGATTGCTAAG|ACTTAGATTCTTAAATTGGAGTCCTGTCAG
GATGCTCAAAGTCTCCAGGAAGCCCCCAAC|ACTTAGATTCTTAAATTGGAATTCTCCCTC
CGGGATTATAGCCAACCAGGGCTAGATACT|TTGGGCGATAAGTAACAGAGGACCAGCGAA
ACTGTGTAGATGAGGGTAGCCGCCATCGAC|TGTTCAGCATGGACTCCATTTTCTGGTTGA
ATGGTCGGCCTGCGTTCTAGCCATCCACCG|CATGAGCGCTTGCGCTGGCGTGAGCATTCA
CCTGTCAGGGCTAGATACTTAGATTCTTAA|TTAAATTGGCGTTTTACGACGCCGACACAC
TCAGGGCTAGATACTTAGATTCTCAGGGCT|AAAAGAACACGGCCGTTGACAGCACCATTG
CGCCGACACACACATCAGGGCTAGATACTT|AATTTCGGGATTATAGCCAACCAGGGCTAG
ATGCTCAAAGTCTCCAGGAAGCCCCCAACG|CTTAGATTCTTAAATTGGAATTCTCCCTCA
GACGGGCAACTCAGGGGTCTCAGGATCAAC|ATTGGTCCAAGCGCCATTGAGCCGAACTAG
TAACGTATGCTGAACAGACAGCATCTAAGC|CTTACAGGGCTAGATACTTAGATTCTTAAA
GGGATTATAGCCAACCAGGGCTAGATACTT|TGGGCGATAAGTAACAGAGGACCAGCGAAT
TGAAGCAGGGCTAGATACTTAGATTCTTAA|CCAGCCAGCGGTGTCTGCAGGGCTAGATAC
CCCCAACGTGACAAGGGGTCCTTACCAGCC|CTCCCTCAACTAGGGCTCCATCGCTCAGGG
GCTGCGGTGGGCAGCATGCAGCTTACGCAG|CCAGGAAGCCCCCAACGTGACAAGGGGTCC
TAGATACTTAGATTCTTAAATTGGAATTCT|CAGGGCTAGATACTTAGATTCTTAAATTGG
CAGGGCTAGATACTTAGATTCTTAAATTGG|CGTAACGTATGCTGAACAGACAGCATCTAA
TGCAGCTTACGCAGAACTGAAGCAGGGCTA|GTGACAAGGGGTCCTTACCAGCCAGCGGTG
TCTTAAATTGGAAATTGGGCGTAGCGGCTA|CTCAGGGCTAGATACTTAGATTCTTAAATT
TTCTTAAATTGGGCGATAAGTAACAGAGGA|TTACTGTGTAGATGAGGGTAGCCGCCATCG
GAACAGACAGCATCTAAGCGCCGCTCCGCT|AGATACTTAGATTCTTAAATTGGGATTCTT
TAGATTCTTAAATTGGTAAATTGGGAGGCA|AGGATACCATGACAGAAGTGGATGGTCGGC
CCGTGTCGTGGCTCAAGTTTCATTGGTCCA|ATACAACCGCCACAGCCTCTGAGTCGCACC
ATACTTAGATTCTTAAATTGGCCCAACACA|GTCTCAGGATCAACTCTATGAAATAGCAGG
ACATAATTTCGGGATTATAGCCAACCAGGG|ATTCTTAAATTGGGCGATAAGTAACAGAGG
ACCGATCGTCGGTGATTCTATACAACCGCC|GAAGTCCCCTAGGGTCATGTCTGCATTAAG
TTCTTAAATTGGAGTCCTGTCAGGGCTAGA|TAGATACTTAGATTCTTAAATTGGCGTTTT
CTTAAATTGGGCGATAAGTAACAGAGGACC|ACTGTGTAGATGAGGGTAGCCGCCATCGAC
ATCGGAAAAGAACACGGCCGTTGACAGCAC|GTGCTAACGTCCACCCCAAGGCAGGGCTAG
ACGTATGCTGAACAGACAGCATCTAAGCGC|TACAGGGCTAGATACTTAGATTCTTAAATT
AAATTGGGCGATAAGTAACAGAGGACCAGC|GTGTAGATGAGGGTAGCCGCCATCGACCGA
CTGGCGTGAGCATTCACGCCTCGGAGTAGC|CTTAAATTGGTGGAGTATAGGATGCTCAAA
ACTTAGATTCTTCAGGGCTAGATACTTAGA|TACCAGAACCTCAGGGCTAGATACTTAGAT
CTCTATGAAATAGCAGGGCTAGATACTTAG|GAACTCGTGGGCGCCTCACGTCCAAGCTAC
TACCAGCCAGCGGTGTCTGCAGGGCTAGAT|GCTCAGGGCTAGATACTTAGATTCTTAAAT
GGCTAGATACTTAGATTCTTAAATTGGTAA|ATTGCACGAGTAGGATACCATGACAGAAGT
TTAGATTCTTAAATTGGCCCAACACAGTAA|CAGGATCAACTCTATGAAATAGCAGGGCTA
AGGGCTAGATACTTAGATTCTTAAATTGGA|GGCTAGATACTTAGATTCTTAAATTGGAGT
AATCGCAGCAGAGTGCTAACGTCCACCCCA|TGGGCAGCATGCAGCTTACGCAGAACTGAA
TTCTTCAGGGCTAGATACTTAGATTCTTAA|ACCTCAGGGCTAGATACTTAGATTCTCAGG
GATGAGGGTAGCCGCCATCGACCGATCGTC|ATGGACTCCATTTTCTGGTTGAAGTCCCCT
TTGCGCTGCGGCTCTCCTTGGTGTTCAGCA|GGACGATGACTAGTCACATGGGCCTTTCGG
TGGAGTCCTGTCAGGGCTAGATACTTAGAT|AGATTCTTAAATTGGCGTTTTACGACGCCG
CTAGATACTTAGATTCTTAAATTGGGCGAT|CGTCCAAGCTACCTTACTGTGTAGATGAGG
ATTCTTAAATTGGATTGCTAAGGTCCATGA|TCTTAAATTGGAGTCCTGTCAGGGCTAGAT
CATCGCTCAGGGCTAGATACTTAGATTCTT|GACGGGCAACTCAGGGGTCTCAGGATCAAC
ATACTTAGATTCTTAAATTGGTAGACAGGG|TGCTGAACAGACAGCATCTAAGCGCCGCTC
CATGACAGAAGTGGATGGTCGGCCTGCGTT|GGATTGCTAAGGTCCATGAGCGCTTGCGCT
CTGAACAGACAGCATCTAAGCGCCGCTCCG|CTAGATACTTAGATTCTTAAATTGGGATTC
GGCTAGATACTTAGATTCTTAAATTGGGAT|ACCGTGTCTAAGTGGAACCAACACTCCAAA
AAATTGGATCGGAAAAGAACACGGCCGTTG|CAGCAGAGTGCTAACGTCCACCCCAAGGCA
TCCTTACCAGCCAGCGGTGTCTGCAGGGCT|CATCGCTCAGGGCTAGATACTTAGATTCTT
ACACACATCAGGGCTAGATACTTAGATTCT|GGATTATAGCCAACCAGGGCTAGATACTTA
TCTCTCGACCGTAACGTATGCTGAACAGAC|AGGGCTAGATACTTACAGGGCTAGATACTT
CAACACTCCAAAATCGCAGCAGAGTGCTAA|AGGTGCTGCGGTGGGCAGCATGCAGCTTAC
ACTCTATGAAATAGCAGGGCTAGATACTTA|AGAACTCGTGGGCGCCTCACGTCCAAGCTA
GCAGCATGCAGCTTACGCAGAACTGAAGCA|CCCAACGTGACAAGGGGTCCTTACCAGCCA
AACCTATATCACCATTGCGCTGCGGCTCTC|CGTATCTCCGCCAGGGACGATGACTAGTCA
AATTGGGAGGCAGGGCTAGATACTTACAGG|TGGATGGTCGGCCTGCGTTCTAGCCATCCA
ATCGCAGCAGAGTGCTAACGTCCACCCCAA|GGGCAGCATGCAGCTTACGCAGAACTGAAG
CGAATAACGAGTCACCCGTGTCGTGGCTCA|ATCGTCGGTGATTCTATACAACCGCCACAG
GCTAGATACTTACAGGGCTAGATACTTAGA|GCGTTCTAGCCATCCACCGTGTCTAAGTGG
TCGAGTTTCCGGCAGACGAACCTATATCAC|GTGGAGGTCTACTGTGTGCGTATCTCCGCC
CCTCACGTCCAAGCTACCTTACTGTGTAGA|TGCGCTGCGGCTCTCCTTGGTGTTCAGCAT
GGCTAGATACTTAGATTCTTAAATTGGCGT|TCTTAAATTGGCCCAACACAGTAAATGAGC
TTAAATTGGGATTCTTAAATTGGATCGGAA|CAACACTCCAAAATCGCAGCAGAGTGCTAA
CTAGATACTTAGATTCTTAAATTGGTGGAG|GTTTTACGACGCCGACACACACATCAGGGC
GGGCTAGATACTTAGATTCTTAAATTGGAA|GGCTAGATACTTAGATTCTCAGGGCTAGAT
TGTCAGGGCTAGATACTTAGATTCTTAAAT|AAATTGGCGTTTTACGACGCCGACACACAC
GCGTGAGCATTCACGCCTCGGAGTAGCAGG|AAATTGGTGGAGTATAGGATGCTCAAAGTC
CAAGAAGGACTCACAGGGCTAGATACTTAG|AAGCTCTCTCGACCGTAACGTATGCTGAAC
TAAGTGGAACCAACACTCCAAAATCGCAGC|TCGGAGTAGCAGGTGCTGCGGTGGGCAGCA
TTAGATTCTCAGGGCTAGATACTTAGATTC|GTTGACAGCACCATTGCACGAGTAGGATAC
TGGAACCAACACTCCAAAATCGCAGCAGAG|AGTAGCAGGTGCTGCGGTGGGCAGCATGCA
TACTTAGATTCTTAAATTGGAGTCCTGTCA|TGCAGGGCTAGATACTTAGATTCTTAAATT
GGGGTCCTTACCAGCCAGCGGTGTCTGCAG|GCTCCATCGCTCAGGGCTAGATACTTAGAT
AGATACTTAGATTCTTAAATTGGTAAATTG|CACGAGTAGGATACCATGACAGAAGTGGAT
TACTTAGATTCTTAAATTGGAATTCTCCCT|GCTAGATACTTAGATTCTTAAATTGGCGCG
AAATTGGAGTCCTGTCAGGGCTAGATACTT|ACTTAGATTCTTAAATTGGCGTTTTACGAC
AACCAGGGCTAGATACTTAGATTCTTAAAT|AACAGAGGACCAGCGAATAACGAGTCACCC
TAGAGAAGCTCTCTCGACCGTAACGTATGC|TTGGGAGGCAGGGCTAGATACTTACAGGGC
GTAACGTATGCTGAACAGACAGCATCTAAG|ACTTACAGGGCTAGATACTTAGATTCTTAA
AGGGCTAGATACTTAGATTCTTAAATTGGC|GAGGACCAGCGAATAACGAGTCACCCGTGT
AGATACTTAGATTCTTAAATTGGTGGAGTA|TTTACGACGCCGACACACACATCAGGGCTA
GGTCTCAGGATCAACTCTATGAAATAGCAG|ATTGAGCCGAACTAGAACTCGTGGGCGCCT
AGCAGAGTGCTAACGTCCACCCCAAGGCAG|GCATGCAGCTTACGCAGAACTGAAGCAGGG
ATTGGTCCAAGCGCCATTGAGCCGAACTAG|AGTCGCACCTCGAGTTTCCGGCAGACGAAC
GGCAGCATGCAGCTTACGCAGAACTGAAGC|CCCCAACGTGACAAGGGGTCCTTACCAGCC
TACTTAGATTCTCAGGGCTAGATACTTAGA|GCCGTTGACAGCACCATTGCACGAGTAGGA
GAGTAGGATACCATGACAGAAGTGGATGGT|ATTCTTAAATTGGATTGCTAAGGTCCATGA
TAAGTAACAGAGGACCAGCGAATAACGAGT|GGTAGCCGCCATCGACCGATCGTCGGTGAT
TTAGATTCTTAAATTGGCGCGCTCACTCCA|ATAACGAGTCACCCGTGTCGTGGCTCAAGT
AGCTACCTTACTGTGTAGATGAGGGTAGCC|TCTCCTTGGTGTTCAGCATGGACTCCATTT
ATGCAGCTTACGCAGAACTGAAGCAGGGCT|CGTGACAAGGGGTCCTTACCAGCCAGCGGT
GCCTCACGTCCAAGCTACCTTACTGTGTAG|TTGCGCTGCGGCTCTCCTTGGTGTTCAGCA
AGATACTTAGATTCTTAAATTGGCGTTTTA|AAATTGGCCCAACACAGTAAATGAGCTAAA
AACTCGTGGGCGCCTCACGTCCAAGCTACC|CTATATCACCATTGCGCTGCGGCTCTCCTT
CCAACACAGTAAATGAGCTAAACATAATTT|ATAGCAGGGCTAGATACTTAGATTCTTAAA
ACATCAGGGCTAGATACTTAGATTCTTAAA|TATAGCCAACCAGGGCTAGATACTTAGATT
CGGTGGGCAGCATGCAGCTTACGCAGAACT|GAAGCCCCCAACGTGACAAGGGGTCCTTAC
CTAGAACTCGTGGGCGCCTCACGTCCAAGC|GAACCTATATCACCATTGCGCTGCGGCTCT
TGCGGTGGGCAGCATGCAGCTTACGCAGAA|AGGAAGCCCCCAACGTGACAAGGGGTCCTT
ACTTAGATTCTTAAATTGGTAAATTGGGAG|AGTAGGATACCATGACAGAAGTGGATGGTC
CTATACAACCGCCACAGCCTCTGAGTCGCA|TGTCTGCATTAAGGTCGATAGTAGGCGCTA
GATTCTTAAATTGGAGTCCTGTCAGGGCTA|GCTAGATACTTAGATTCTTAAATTGGCGTT
AAATTGGCGTTTTACGACGCCGACACACAC|GTAAATGAGCTAAACATAATTTCGGGATTA
GGATTCTTAAATTGGATCGGAAAAGAACAC|CAAAATCGCAGCAGAGTGCTAACGTCCACC
GAGTCCTGTCAGGGCTAGATACTTAGATTC|ATTCTTAAATTGGCGTTTTACGACGCCGAC
TTCTTAAATTGGGATTCTTAAATTGGATCG|AACCAACACTCCAAAATCGCAGCAGAGTGC
AGTAAATGAGCTAAACATAATTTCGGGATT|GGCTAGATACTTAGATTCTTAAATTGGGCG
CTTAAATTGGCCCAACACAGTAAATGAGCT|AACTCTATGAAATAGCAGGGCTAGATACTT
TGAGCTAAACATAATTTCGGGATTATAGCC|ATACTTAGATTCTTAAATTGGGCGATAAGT
AATTGGCGTTTTACGACGCCGACACACACA|TAAATGAGCTAAACATAATTTCGGGATTAT
GATTCTTAAATTGGAAATTGGGCGTAGCGG|ATTCTCAGGGCTAGATACTTAGATTCTTAA
ATTCTTAAATTGGCGCGCTCACTCCAGGAG|CGAGTCACCCGTGTCGTGGCTCAAGTTTCA
GCTCCATCGCTCAGGGCTAGATACTTAGAT|AGGAGACGGGCAACTCAGGGGTCTCAGGAT
GTAGGATACCATGACAGAAGTGGATGGTCG|TCTTAAATTGGATTGCTAAGGTCCATGAGC
TACAACCGCCACAGCCTCTGAGTCGCACCT|CTGCATTAAGGTCGATAGTAGGCGCTAGAG
CTAGATACTTAGATTCTTAAATTGGAATTC|CCAGGGCTAGATACTTAGATTCTTAAATTG
GTCCATGAGCGCTTGCGCTGGCGTGAGCAT|GGCTAGATACTTAGATTCTTAAATTGGTGG
CTAGGGCTCCATCGCTCAGGGCTAGATACT|ACTCCAGGAGACGGGCAACTCAGGGGTCTC
AGCTAAACATAATTTCGGGATTATAGCCAA|ACTTAGATTCTTAAATTGGGCGATAAGTAA
TGGCGTGAGCATTCACGCCTCGGAGTAGCA|TTAAATTGGTGGAGTATAGGATGCTCAAAG
TTAAATTGGCGCGCTCACTCCAGGAGACGG|TCACCCGTGTCGTGGCTCAAGTTTCATTGG
AAATAGAGAAGCTCTCTCGACCGTAACGTA|AAATTGGGAGGCAGGGCTAGATACTTACAG
ACGCCTCGGAGTAGCAGGTGCTGCGGTGGG|TATAGGATGCTCAAAGTCTCCAGGAAGCCC
GGAAGCCCCCAACGTGACAAGGGGTCCTTA|GGAATTCTCCCTCAACTAGGGCTCCATCGC
GGAAAAGAACACGGCCGTTGACAGCACCAT|CTAACGTCCACCCCAAGGCAGGGCTAGATA
CTCAGGGCTAGATACTTAGATTCTTAAATT|GCACCATTGCACGAGTAGGATACCATGACA
TGCTAACGTCCACCCCAAGGCAGGGCTAGA|GCTTACGCAGAACTGAAGCAGGGCTAGATA
GGCTAGATACTTACAGGGCTAGATACTTAG|TGCGTTCTAGCCATCCACCGTGTCTAAGTG
GCGAATAACGAGTCACCCGTGTCGTGGCTC|GATCGTCGGTGATTCTATACAACCGCCACA
TAGATACTTAGATTCTTAAATTGGTAAATT|GCACGAGTAGGATACCATGACAGAAGTGGA
TTCGGGATTATAGCCAACCAGGGCTAGATA|AATTGGGCGATAAGTAACAGAGGACCAGCG
GTGTAGATGAGGGTAGCCGCCATCGACCGA|TCAGCATGGACTCCATTTTCTGGTTGAAGT
GGGCGATAAGTAACAGAGGACCAGCGAATA|GATGAGGGTAGCCGCCATCGACCGATCGTC
AAAGAACACGGCCGTTGACAGCACCATTGC|ACGTCCACCCCAAGGCAGGGCTAGATACTT
GAAGCAGGGCTAGATACTTAGATTCTTAAA|CAGCCAGCGGTGTCTGCAGGGCTAGATACT
CGACCGATCGTCGGTGATTCTATACAACCG|TTGAAGTCCCCTAGGGTCATGTCTGCATTA
GTCCTTACCAGCCAGCGGTGTCTGCAGGGC|CCATCGCTCAGGGCTAGATACTTAGATTCT
ACCTCGAGTTTCCGGCAGACGAACCTATAT|AGAGTGGAGGTCTACTGTGTGCGTATCTCC
TGAGCATTCACGCCTCGGAGTAGCAGGTGC|TTGGTGGAGTATAGGATGCTCAAAGTCTCC
GAATAACGAGTCACCCGTGTCGTGGCTCAA|TCGTCGGTGATTCTATACAACCGCCACAGC
CCGCCACAGCCTCTGAGTCGCACCTCGAGT|TTAAGGTCGATAGTAGGCGCTAGAGTGGAG
TTGGGAGGCAGGGCTAGATACTTACAGGGC|GATGGTCGGCCTGCGTTCTAGCCATCCACC
CTGCGTTCTAGCCATCCACCGTGTCTAAGT|TTGCGCTGGCGTGAGCATTCACGCCTCGGA
GATCAACTCTATGAAATAGCAGGGCTAGAT|GAACTAGAACTCGTGGGCGCCTCACGTCCA
GTGTCGTGGCTCAAGTTTCATTGGTCCAAG|ACAACCGCCACAGCCTCTGAGTCGCACCTC
TGAGGGTAGCCGCCATCGACCGATCGTCGG|GGACTCCATTTTCTGGTTGAAGTCCCCTAG
TAGATTCTTAAATTGGGCGATAAGTAACAG|TACCTTACTGTGTAGATGAGGGTAGCCGCC
AATACCAGAACCTCAGGGCTAGATACTTAG|AAATTGGATCGGAAAAGAACACGGCCGTTG
TGAGCCGAACTAGAACTCGTGGGCGCCTCA|CCGGCAGACGAACCTATATCACCATTGCGC
ACTCAGGGGTCTCAGGATCAACTCTATGAA|AAGCGCCATTGAGCCGAACTAGAACTCGTG
CTAGATACTTAGATTCTCAGGGCTAGATAC|ACACGGCCGTTGACAGCACCATTGCACGAG
TCCCTCAACTAGGGCTCCATCGCTCAGGGC|GCGCGCTCACTCCAGGAGACGGGCAACTCA
CAGCATCTAAGCGCCGCTCCGCTAATACCA|TAGATTCTTAAATTGGGATTCTTAAATTGG
ATTGGGCGTAGCGGCTATCTAAATAGAGAA|ACTTAGATTCTTAAATTGGTAAATTGGGAG
TTAAATTGGAAATTGGGCGTAGCGGCTATC|CAGGGCTAGATACTTAGATTCTTAAATTGG
TAGATTCTTAAATTGGCCCAACACAGTAAA|AGGATCAACTCTATGAAATAGCAGGGCTAG
TCCAGGAAGCCCCCAACGTGACAAGGGGTC|AATTGGAATTCTCCCTCAACTAGGGCTCCA
GCTAACGTCCACCCCAAGGCAGGGCTAGAT|CTTACGCAGAACTGAAGCAGGGCTAGATAC
ACCTCAGGGCTAGATACTTAGATTCTCAGG|CGGAAAAGAACACGGCCGTTGACAGCACCA
CGTGGGCGCCTCACGTCCAAGCTACCTTAC|ATCACCATTGCGCTGCGGCTCTCCTTGGTG
GGAACCAACACTCCAAAATCGCAGCAGAGT|GTAGCAGGTGCTGCGGTGGGCAGCATGCAG
TCAGGGCTAGATACTTAGATTCTTAAATTG|CACCATTGCACGAGTAGGATACCATGACAG
CTGAGTCGCACCTCGAGTTTCCGGCAGACG|GTAGGCGCTAGAGTGGAGGTCTACTGTGTG
ATACTTAGATTCTTAAATTGGCGCGCTCAC|GCGAATAACGAGTCACCCGTGTCGTGGCTC
TCTTAAATTGGCGCGCTCACTCCAGGAGAC|AGTCACCCGTGTCGTGGCTCAAGTTTCATT
CCGAACTAGAACTCGTGGGCGCCTCACGTC|CAGACGAACCTATATCACCATTGCGCTGCG
CCGCCATCGACCGATCGTCGGTGATTCTAT|TTTCTGGTTGAAGTCCCCTAGGGTCATGTC
CTCGACCGTAACGTATGCTGAACAGACAGC|GCTAGATACTTACAGGGCTAGATACTTAGA
CTCCAGGAGACGGGCAACTCAGGGGTCTCA|CAAGTTTCATTGGTCCAAGCGCCATTGAGC
CGAGTTTCCGGCAGACGAACCTATATCACC|TGGAGGTCTACTGTGTGCGTATCTCCGCCA
AGGGGTCTCAGGATCAACTCTATGAAATAG|GCCATTGAGCCGAACTAGAACTCGTGGGCG
ATTCTTAAATTGGTGGAGTATAGGATGCTC|CGACACACACATCAGGGCTAGATACTTAGA
ATACCAGAACCTCAGGGCTAGATACTTAGA|AATTGGATCGGAAAAGAACACGGCCGTTGA
CAACTAGGGCTCCATCGCTCAGGGCTAGAT|CTCACTCCAGGAGACGGGCAACTCAGGGGT
TTAAATTGGAATTCTCCCTCAACTAGGGCT|AGATTCTTAAATTGGCGCGCTCACTCCAGG
CTTAAATTGGAATTCTCCCTCAACTAGGGC|TAGATTCTTAAATTGGCGCGCTCACTCCAG
ACGAGTAGGATACCATGACAGAAGTGGATG|AGATTCTTAAATTGGATTGCTAAGGTCCAT
AAGGACTCACAGGGCTAGATACTTAGATTC|TCTCTCGACCGTAACGTATGCTGAACAGAC
ACAGGGCTAGATACTTAGATTCTTAAATTG|CCGTAACGTATGCTGAACAGACAGCATCTA
TCTCCCTCAACTAGGGCTCCATCGCTCAGG|TGGCGCGCTCACTCCAGGAGACGGGCAACT
TAGCAGGTGCTGCGGTGGGCAGCATGCAGC|CAAAGTCTCCAGGAAGCCCCCAACGTGACA
CACAGCCTCTGAGTCGCACCTCGAGTTTCC|GGTCGATAGTAGGCGCTAGAGTGGAGGTCT
CCAAGCGCCATTGAGCCGAACTAGAACTCG|ACCTCGAGTTTCCGGCAGACGAACCTATAT
CGCCACAGCCTCTGAGTCGCACCTCGAGTT|TAAGGTCGATAGTAGGCGCTAGAGTGGAGG
GTCTCCAGGAAGCCCCCAACGTGACAAGGG|TTAAATTGGAATTCTCCCTCAACTAGGGCT
CCAGGAAGCCCCCAACGTGACAAGGGGTCC|ATTGGAATTCTCCCTCAACTAGGGCTCCAT
AGAACACGGCCGTTGACAGCACCATTGCAC|GTCCACCCCAAGGCAGGGCTAGATACTTAG
CTAGATACTTAGATTCTTAAATTGGCCCAA|AGGGGTCTCAGGATCAACTCTATGAAATAG
ATAACGAGTCACCCGTGTCGTGGCTCAAGT|GTCGGTGATTCTATACAACCGCCACAGCCT
AAGTGGATGGTCGGCCTGCGTTCTAGCCAT|AAGGTCCATGAGCGCTTGCGCTGGCGTGAG
CCATCGACCGATCGTCGGTGATTCTATACA|CTGGTTGAAGTCCCCTAGGGTCATGTCTGC
ATTGGGAGGCAGGGCTAGATACTTACAGGG|GGATGGTCGGCCTGCGTTCTAGCCATCCAC
ATTCTTAAATTGGGATTCTTAAATTGGATC|GAACCAACACTCCAAAATCGCAGCAGAGTG
GATACTTAGATTCTTAAATTGGGATTCTTA|GTCTAAGTGGAACCAACACTCCAAAATCGC
CCGACACACACATCAGGGCTAGATACTTAG|TTTCGGGATTATAGCCAACCAGGGCTAGAT
ACAGGGCTAGATACTTAGATTCTTAAATTG|ATCCACCGTGTCTAAGTGGAACCAACACTC
GGGCTAGATACTTAGATTCTTAAATTGGAA|CAACCAGGGCTAGATACTTAGATTCTTAAA
CAACTCAGGGGTCTCAGGATCAACTCTATG|CCAAGCGCCATTGAGCCGAACTAGAACTCG
AGGGGTCAAGAAGGACTCACAGGGCTAGAT|ATAGAGAAGCTCTCTCGACCGTAACGTATG
GAGGGGTCAAGAAGGACTCACAGGGCTAGA|AATAGAGAAGCTCTCTCGACCGTAACGTAT
CTCCATCGCTCAGGGCTAGATACTTAGATT|GGAGACGGGCAACTCAGGGGTCTCAGGATC
GCTAGATACTTAGATTCTTAAATTGGATTG|TAGATACTTAGATTCTTAAATTGGAGTCCT
CTAGATACTTAGATTCTTCAGGGCTAGATA|CGCTAATACCAGAACCTCAGGGCTAGATAC
CTTAAATTGGCGCGCTCACTCCAGGAGACG|GTCACCCGTGTCGTGGCTCAAGTTTCATTG
CTCACAGGGCTAGATACTTAGATTCTTAAA|CGACCGTAACGTATGCTGAACAGACAGCAT
TTCATTGGTCCAAGCGCCATTGAGCCGAAC|CTGAGTCGCACCTCGAGTTTCCGGCAGACG
GGCCCAACACAGTAAATGAGCTAAACATAA|GAAATAGCAGGGCTAGATACTTAGATTCTT
GATTCTTAAATTGGTAGACAGGGCTAGATA|CAGACAGCATCTAAGCGCCGCTCCGCTAAT
CGTGTCTAAGTGGAACCAACACTCCAAAAT|CACGCCTCGGAGTAGCAGGTGCTGCGGTGG
GCTAGATACTTAGATTCTTAAATTGGCCCA|CAGGGGTCTCAGGATCAACTCTATGAAATA
GGTCGGCCTGCGTTCTAGCCATCCACCGTG|TGAGCGCTTGCGCTGGCGTGAGCATTCACG
TTAGATTCTTAAATTGGGCGATAAGTAACA|CTACCTTACTGTGTAGATGAGGGTAGCCGC
ACAGCACCATTGCACGAGTAGGATACCATG|GGGCTAGATACTTAGATTCTTAAATTGGAT
AAATTGGTAAATTGGGAGGCAGGGCTAGAT|TGACAGAAGTGGATGGTCGGCCTGCGTTCT
TGGTCCAAGCGCCATTGAGCCGAACTAGAA|TCGCACCTCGAGTTTCCGGCAGACGAACCT
CCCAACGTGACAAGGGGTCCTTACCAGCCA|TCCCTCAACTAGGGCTCCATCGCTCAGGGC
TTCTTAAATTGGATTGCTAAGGTCCATGAG|CTTAAATTGGAGTCCTGTCAGGGCTAGATA
AGCGCCGCTCCGCTAATACCAGAACCTCAG|AAATTGGGATTCTTAAATTGGATCGGAAAA
TGGATTGCTAAGGTCCATGAGCGCTTGCGC|GAGTCCTGTCAGGGCTAGATACTTAGATTC
ATCAGGGCTAGATACTTAGATTCTTAAATT|TAGCCAACCAGGGCTAGATACTTAGATTCT
GATACTTAGATTCTTAAATTGGCCCAACAC|GGTCTCAGGATCAACTCTATGAAATAGCAG
GTAGCGGCTATCTAAATAGAGAAGCTCTCT|TTCTTAAATTGGTAAATTGGGAGGCAGGGC
AAATTGGAATTCTCCCTCAACTAGGGCTCC|ATTCTTAAATTGGCGCGCTCACTCCAGGAG
TGAGCGCTTGCGCTGGCGTGAGCATTCACG|GATACTTAGATTCTTAAATTGGTGGAGTAT
TGTCTAAGTGGAACCAACACTCCAAAATCG|CGCCTCGGAGTAGCAGGTGCTGCGGTGGGC
GAAGCTCTCTCGACCGTAACGTATGCTGAA|GAGGCAGGGCTAGATACTTACAGGGCTAGA
AAATTGGCCCAACACAGTAAATGAGCTAAA|TCTATGAAATAGCAGGGCTAGATACTTAGA
ACCGCCACAGCCTCTGAGTCGCACCTCGAG|ATTAAGGTCGATAGTAGGCGCTAGAGTGGA
GGTGTCTGCAGGGCTAGATACTTAGATTCT|GATACTTAGATTCTTAAATTGGCCCAACAC
CGGTGATTCTATACAACCGCCACAGCCTCT|TAGGGTCATGTCTGCATTAAGGTCGATAGT
AGGGCTAGATACTTAGATTCTTAAATTGGA|AGCGGTGTCTGCAGGGCTAGATACTTAGAT
AATTGGGATTCTTAAATTGGATCGGAAAAG|CACTCCAAAATCGCAGCAGAGTGCTAACGT
AGGGCTAGATACTTAGATTCTTAAATTGGT|CCATTGCACGAGTAGGATACCATGACAGAA
CTGTGTAGATGAGGGTAGCCGCCATCGACC|GTTCAGCATGGACTCCATTTTCTGGTTGAA
CTTAGATTCTTAAATTGGCGTTTTACGACG|GGCCCAACACAGTAAATGAGCTAAACATAA
AACAGACAGCATCTAAGCGCCGCTCCGCTA|GATACTTAGATTCTTAAATTGGGATTCTTA
CTGTCAGGGCTAGATACTTAGATTCTTAAA|TAAATTGGCGTTTTACGACGCCGACACACA
TCTAGCCATCCACCGTGTCTAAGTGGAACC|TGGCGTGAGCATTCACGCCTCGGAGTAGCA
TAGGATGCTCAAAGTCTCCAGGAAGCCCCC|GATACTTAGATTCTTAAATTGGAATTCTCC
CGACACACACATCAGGGCTAGATACTTAGA|TTCGGGATTATAGCCAACCAGGGCTAGATA
CTCAACTAGGGCTCCATCGCTCAGGGCTAG|CGCTCACTCCAGGAGACGGGCAACTCAGGG
AATGAGCTAAACATAATTTCGGGATTATAG|AGATACTTAGATTCTTAAATTGGGCGATAA
AGCCAACCAGGGCTAGATACTTAGATTCTT|AAGTAACAGAGGACCAGCGAATAACGAGTC
AGATACTTAGATTCTTAAATTGGGCGATAA|TCCAAGCTACCTTACTGTGTAGATGAGGGT
GATACTTAGATTCTTAAATTGGGCGATAAG|CCAAGCTACCTTACTGTGTAGATGAGGGTA
ACCCGTGTCGTGGCTCAAGTTTCATTGGTC|CTATACAACCGCCACAGCCTCTGAGTCGCA
GGCAGACGAACCTATATCACCATTGCGCTG|ACTGTGTGCGTATCTCCGCCAGGGACGATG
ATCGACCGATCGTCGGTGATTCTATACAAC|GGTTGAAGTCCCCTAGGGTCATGTCTGCAT
GATTCTCAGGGCTAGATACTTAGATTCTTA|GACAGCACCATTGCACGAGTAGGATACCAT
AAGTCTCCAGGAAGCCCCCAACGTGACAAG|TCTTAAATTGGAATTCTCCCTCAACTAGGG
GCAGGTGCTGCGGTGGGCAGCATGCAGCTT|AAGTCTCCAGGAAGCCCCCAACGTGACAAG
TCCGGCAGACGAACCTATATCACCATTGCG|TCTACTGTGTGCGTATCTCCGCCAGGGACG
AAATTGGTGGAGTATAGGATGCTCAAAGTC|ACACATCAGGGCTAGATACTTAGATTCTTA
GATACTTAGATTCTCAGGGCTAGATACTTA|CGGCCGTTGACAGCACCATTGCACGAGTAG
CGCTGGCGTGAGCATTCACGCCTCGGAGTA|TTCTTAAATTGGTGGAGTATAGGATGCTCA
AACTAGGGCTCCATCGCTCAGGGCTAGATA|TCACTCCAGGAGACGGGCAACTCAGGGGTC
GCCGACACACACATCAGGGCTAGATACTTA|ATTTCGGGATTATAGCCAACCAGGGCTAGA
CTATATCACCATTGCGCTGCGGCTCTCCTT|ATCTCCGCCAGGGACGATGACTAGTCACAT
GGCTAGATACTTAGATTCTTAAATTGGTGG|GCGTTTTACGACGCCGACACACACATCAGG
TCGGTGATTCTATACAACCGCCACAGCCTC|CTAGGGTCATGTCTGCATTAAGGTCGATAG
GCGGCTATCTAAATAGAGAAGCTCTCTCGA|TTAAATTGGTAAATTGGGAGGCAGGGCTAG
GGCGCCTCACGTCCAAGCTACCTTACTGTG|CCATTGCGCTGCGGCTCTCCTTGGTGTTCA
AGCGCTTGCGCTGGCGTGAGCATTCACGCC|TACTTAGATTCTTAAATTGGTGGAGTATAG
AGCAGGTGCTGCGGTGGGCAGCATGCAGCT|AAAGTCTCCAGGAAGCCCCCAACGTGACAA
CTTAGATTCTTAAATTGGTAGACAGGGCTA|TGAACAGACAGCATCTAAGCGCCGCTCCGC
GATTCTTAAATTGGCGTTTTACGACGCCGA|CAACACAGTAAATGAGCTAAACATAATTTC
GGGATTCTTAAATTGGATCGGAAAAGAACA|CCAAAATCGCAGCAGAGTGCTAACGTCCAC
CGGCCTGCGTTCTAGCCATCCACCGTGTCT|GCGCTTGCGCTGGCGTGAGCATTCACGCCT
CCATTGAGCCGAACTAGAACTCGTGGGCGC|GTTTCCGGCAGACGAACCTATATCACCATT
GCTACCTTACTGTGTAGATGAGGGTAGCCG|CTCCTTGGTGTTCAGCATGGACTCCATTTT
TAAATTGGTGGAGTATAGGATGCTCAAAGT|CACACATCAGGGCTAGATACTTAGATTCTT
TACTTAGATTCTTAAATTGGCCCAACACAG|TCTCAGGATCAACTCTATGAAATAGCAGGG
AGTGGATGGTCGGCCTGCGTTCTAGCCATC|AGGTCCATGAGCGCTTGCGCTGGCGTGAGC
GCAGCTTACGCAGAACTGAAGCAGGGCTAG|TGACAAGGGGTCCTTACCAGCCAGCGGTGT
TCAAAGTCTCCAGGAAGCCCCCAACGTGAC|GATTCTTAAATTGGAATTCTCCCTCAACTA
TAGCGGCTATCTAAATAGAGAAGCTCTCTC|TCTTAAATTGGTAAATTGGGAGGCAGGGCT
GATTGCTAAGGTCCATGAGCGCTTGCGCTG|GTCCTGTCAGGGCTAGATACTTAGATTCTT
CGATAAGTAACAGAGGACCAGCGAATAACG|GAGGGTAGCCGCCATCGACCGATCGTCGGT
TAAATTGGGCGATAAGTAACAGAGGACCAG|TGTGTAGATGAGGGTAGCCGCCATCGACCG
GCAGACGAACCTATATCACCATTGCGCTGC|CTGTGTGCGTATCTCCGCCAGGGACGATGA
GGTGGAGTATAGGATGCTCAAAGTCTCCAG|TCAGGGCTAGATACTTAGATTCTTAAATTG
CCACCCCAAGGCAGGGCTAGATACTTAGAT|GAACTGAAGCAGGGCTAGATACTTAGATTC
GCTCCGCTAATACCAGAACCTCAGGGCTAG|GGATTCTTAAATTGGATCGGAAAAGAACAC
AAATTGGGCGTAGCGGCTATCTAAATAGAG|ATACTTAGATTCTTAAATTGGTAAATTGGG
GCTAGATACTTAGATTCTTAAATTGGTAGA|ACGTATGCTGAACAGACAGCATCTAAGCGC
GGATGCTCAAAGTCTCCAGGAAGCCCCCAA|TACTTAGATTCTTAAATTGGAATTCTCCCT
GAGTCACCCGTGTCGTGGCTCAAGTTTCAT|TGATTCTATACAACCGCCACAGCCTCTGAG
CACCCGTGTCGTGGCTCAAGTTTCATTGGT|TCTATACAACCGCCACAGCCTCTGAGTCGC
AGGTCCATGAGCGCTTGCGCTGGCGTGAGC|AGGGCTAGATACTTAGATTCTTAAATTGGT
GATAAGTAACAGAGGACCAGCGAATAACGA|AGGGTAGCCGCCATCGACCGATCGTCGGTG
AGGGCTAGATACTTAGATTCTTAAATTGGC|ATTCTTAAATTGGCCCAACACAGTAAATGA
AGATACTTAGATTCTTAAATTGGAATTCTC|AGGGCTAGATACTTAGATTCTTAAATTGGC
CAGTAAATGAGCTAAACATAATTTCGGGAT|GGGCTAGATACTTAGATTCTTAAATTGGGC
TTGCTAAGGTCCATGAGCGCTTGCGCTGGC|CCTGTCAGGGCTAGATACTTAGATTCTTAA
GAGCGCTTGCGCTGGCGTGAGCATTCACGC|ATACTTAGATTCTTAAATTGGTGGAGTATA
ATCGTCGGTGATTCTATACAACCGCCACAG|TCCCCTAGGGTCATGTCTGCATTAAGGTCG
TAAATTGGATCGGAAAAGAACACGGCCGTT|GCAGCAGAGTGCTAACGTCCACCCCAAGGC
TGGTAGACAGGGCTAGATACTTAGATTCTT|TAAGCGCCGCTCCGCTAATACCAGAACCTC
ACCCCAAGGCAGGGCTAGATACTTAGATTC|ACTGAAGCAGGGCTAGATACTTAGATTCTT
AGCCCCCAACGTGACAAGGGGTCCTTACCA|ATTCTCCCTCAACTAGGGCTCCATCGCTCA
CAGCCAGCGGTGTCTGCAGGGCTAGATACT|CAGGGCTAGATACTTAGATTCTTAAATTGG
TCAAGTTTCATTGGTCCAAGCGCCATTGAG|CAGCCTCTGAGTCGCACCTCGAGTTTCCGG
AGTAGCAGGTGCTGCGGTGGGCAGCATGCA|CTCAAAGTCTCCAGGAAGCCCCCAACGTGA
GAACCTCAGGGCTAGATACTTAGATTCTCA|ATCGGAAAAGAACACGGCCGTTGACAGCAC
CAGAACTGAAGCAGGGCTAGATACTTAGAT|TCCTTACCAGCCAGCGGTGTCTGCAGGGCT
GTGATTCTATACAACCGCCACAGCCTCTGA|GGGTCATGTCTGCATTAAGGTCGATAGTAG
GATACTTAGATTCTTAAATTGGAATTCTCC|GGGCTAGATACTTAGATTCTTAAATTGGCG
CGTTCTAGCCATCCACCGTGTCTAAGTGGA|CGCTGGCGTGAGCATTCACGCCTCGGAGTA
GCCAGCGGTGTCTGCAGGGCTAGATACTTA|GGGCTAGATACTTAGATTCTTAAATTGGCC
TTGGTAGACAGGGCTAGATACTTAGATTCT|CTAAGCGCCGCTCCGCTAATACCAGAACCT
ACAGAGGACCAGCGAATAACGAGTCACCCG|CGCCATCGACCGATCGTCGGTGATTCTATA
TCTCAGGGCTAGATACTTAGATTCTTAAAT|AGCACCATTGCACGAGTAGGATACCATGAC
CTCTCTCGACCGTAACGTATGCTGAACAGA|CAGGGCTAGATACTTACAGGGCTAGATACT
CGTTGACAGCACCATTGCACGAGTAGGATA|AGGCAGGGCTAGATACTTAGATTCTTAAAT
CTTAGATTCTTAAATTGGATTGCTAAGGTC|TAGATTCTTAAATTGGAGTCCTGTCAGGGC
GCTTACGCAGAACTGAAGCAGGGCTAGATA|CAAGGGGTCCTTACCAGCCAGCGGTGTCTG
GGACCAGCGAATAACGAGTCACCCGTGTCG|TCGACCGATCGTCGGTGATTCTATACAACC
GTATGCTGAACAGACAGCATCTAAGCGCCG|CAGGGCTAGATACTTAGATTCTTAAATTGG
AACAGAGGACCAGCGAATAACGAGTCACCC|CCGCCATCGACCGATCGTCGGTGATTCTAT
TTGGATTGCTAAGGTCCATGAGCGCTTGCG|GGAGTCCTGTCAGGGCTAGATACTTAGATT
TAGATACTTAGATTCTCAGGGCTAGATACT|CACGGCCGTTGACAGCACCATTGCACGAGT
TCACCCGTGTCGTGGCTCAAGTTTCATTGG|TTCTATACAACCGCCACAGCCTCTGAGTCG
TTAGATTCTTAAATTGGAGTCCTGTCAGGG|AGGGCTAGATACTTAGATTCTTAAATTGGC
CTCCCTCAACTAGGGCTCCATCGCTCAGGG|GGCGCGCTCACTCCAGGAGACGGGCAACTC
TATACAACCGCCACAGCCTCTGAGTCGCAC|GTCTGCATTAAGGTCGATAGTAGGCGCTAG
GATCGGAAAAGAACACGGCCGTTGACAGCA|AGTGCTAACGTCCACCCCAAGGCAGGGCTA
TAGATACTTAGATTCTTAAATTGGTGGAGT|TTTTACGACGCCGACACACACATCAGGGCT
TATAGCCAACCAGGGCTAGATACTTAGATT|GATAAGTAACAGAGGACCAGCGAATAACGA
GCCTCGGAGTAGCAGGTGCTGCGGTGGGCA|TAGGATGCTCAAAGTCTCCAGGAAGCCCCC
AGCTTACGCAGAACTGAAGCAGGGCTAGAT|ACAAGGGGTCCTTACCAGCCAGCGGTGTCT
CGTAACGTATGCTGAACAGACAGCATCTAA|TACTTACAGGGCTAGATACTTAGATTCTTA
TGGGCAGCATGCAGCTTACGCAGAACTGAA|GCCCCCAACGTGACAAGGGGTCCTTACCAG
GTGCTAACGTCCACCCCAAGGCAGGGCTAG|AGCTTACGCAGAACTGAAGCAGGGCTAGAT
ATTCTTAAATTGGTAGACAGGGCTAGATAC|AGACAGCATCTAAGCGCCGCTCCGCTAATA
TCTAAATAGAGAAGCTCTCTCGACCGTAAC|GGTAAATTGGGAGGCAGGGCTAGATACTTA
ATTGGTAAATTGGGAGGCAGGGCTAGATAC|ACAGAAGTGGATGGTCGGCCTGCGTTCTAG
ACAGAAGTGGATGGTCGGCCTGCGTTCTAG|TGCTAAGGTCCATGAGCGCTTGCGCTGGCG
CTTAAATTGGATTGCTAAGGTCCATGAGCG|TAAATTGGAGTCCTGTCAGGGCTAGATACT
AACGTGACAAGGGGTCCTTACCAGCCAGCG|CTCAACTAGGGCTCCATCGCTCAGGGCTAG
CTAGATACTTAGATTCTTAAATTGGATTGC|AGATACTTAGATTCTTAAATTGGAGTCCTG
GCTGAACAGACAGCATCTAAGCGCCGCTCC|GCTAGATACTTAGATTCTTAAATTGGGATT
GCTTGCGCTGGCGTGAGCATTCACGCCTCG|TTAGATTCTTAAATTGGTGGAGTATAGGAT
AGCGCCATTGAGCCGAACTAGAACTCGTGG|TCGAGTTTCCGGCAGACGAACCTATATCAC
GGTCCATGAGCGCTTGCGCTGGCGTGAGCA|GGGCTAGATACTTAGATTCTTAAATTGGTG
AGATTCTTAAATTGGTGGAGTATAGGATGC|GCCGACACACACATCAGGGCTAGATACTTA
TAACGAGTCACCCGTGTCGTGGCTCAAGTT|TCGGTGATTCTATACAACCGCCACAGCCTC
ATACTTACAGGGCTAGATACTTAGATTCTT|CTAGCCATCCACCGTGTCTAAGTGGAACCA
TGCTGAACAGACAGCATCTAAGCGCCGCTC|GGCTAGATACTTAGATTCTTAAATTGGGAT
GTTGACAGCACCATTGCACGAGTAGGATAC|GGCAGGGCTAGATACTTAGATTCTTAAATT
TGGGCGTAGCGGCTATCTAAATAGAGAAGC|TTAGATTCTTAAATTGGTAAATTGGGAGGC
AAAGTCTCCAGGAAGCCCCCAACGTGACAA|TTCTTAAATTGGAATTCTCCCTCAACTAGG
AGGATCAACTCTATGAAATAGCAGGGCTAG|CCGAACTAGAACTCGTGGGCGCCTCACGTC
CAGCGGTGTCTGCAGGGCTAGATACTTAGA|GCTAGATACTTAGATTCTTAAATTGGCCCA
AAGCCCCCAACGTGACAAGGGGTCCTTACC|AATTCTCCCTCAACTAGGGCTCCATCGCTC
GTGGGCAGCATGCAGCTTACGCAGAACTGA|AGCCCCCAACGTGACAAGGGGTCCTTACCA
ACAGCCTCTGAGTCGCACCTCGAGTTTCCG|GTCGATAGTAGGCGCTAGAGTGGAGGTCTA
CACACACATCAGGGCTAGATACTTAGATTC|GGGATTATAGCCAACCAGGGCTAGATACTT
GATACTTAGATTCTTCAGGGCTAGATACTT|TAATACCAGAACCTCAGGGCTAGATACTTA
TCTATGAAATAGCAGGGCTAGATACTTAGA|AACTCGTGGGCGCCTCACGTCCAAGCTACC
ATAGAGAAGCTCTCTCGACCGTAACGTATG|ATTGGGAGGCAGGGCTAGATACTTACAGGG
AGAACTCGTGGGCGCCTCACGTCCAAGCTA|ACCTATATCACCATTGCGCTGCGGCTCTCC
GGATGGTCGGCCTGCGTTCTAGCCATCCAC|TCCATGAGCGCTTGCGCTGGCGTGAGCATT
CTTAGATTCTTAAATTGGTAAATTGGGAGG|GTAGGATACCATGACAGAAGTGGATGGTCG
ATAGCAGGGCTAGATACTTAGATTCTTAAA|GGCGCCTCACGTCCAAGCTACCTTACTGTG
ATTCTTAAATTGGCGTTTTACGACGCCGAC|AACACAGTAAATGAGCTAAACATAATTTCG
TTGAGCCGAACTAGAACTCGTGGGCGCCTC|TCCGGCAGACGAACCTATATCACCATTGCG
ACAGGGCTAGATACTTAGATTCTTCAGGGC|CCGCTCCGCTAATACCAGAACCTCAGGGCT
TTAAATTGGAGTCCTGTCAGGGCTAGATAC|ATACTTAGATTCTTAAATTGGCGTTTTACG
ACCAGGGCTAGATACTTAGATTCTTAAATT|ACAGAGGACCAGCGAATAACGAGTCACCCG
TCTATACAACCGCCACAGCCTCTGAGTCGC|ATGTCTGCATTAAGGTCGATAGTAGGCGCT
TTCTAGCCATCCACCGTGTCTAAGTGGAAC|CTGGCGTGAGCATTCACGCCTCGGAGTAGC
GATTCTTAAATTGGGATTCTTAAATTGGAT|GGAACCAACACTCCAAAATCGCAGCAGAGT
AAGCGCCGCTCCGCTAATACCAGAACCTCA|TAAATTGGGATTCTTAAATTGGATCGGAAA
TACTTACAGGGCTAGATACTTAGATTCTTA|TAGCCATCCACCGTGTCTAAGTGGAACCAA
TTCAGGGCTAGATACTTAGATTCTTAAATT|TCAGGGCTAGATACTTAGATTCTCAGGGCT
ACTTAGATTCTTAAATTGGATTGCTAAGGT|TTAGATTCTTAAATTGGAGTCCTGTCAGGG
CTAACGTCCACCCCAAGGCAGGGCTAGATA|TTACGCAGAACTGAAGCAGGGCTAGATACT
CCCCCAACGTGACAAGGGGTCCTTACCAGC|TCTCCCTCAACTAGGGCTCCATCGCTCAGG
ATCTAAGCGCCGCTCCGCTAATACCAGAAC|TTCTTAAATTGGGATTCTTAAATTGGATCG
CTTACGCAGAACTGAAGCAGGGCTAGATAC|AAGGGGTCCTTACCAGCCAGCGGTGTCTGC
AGGAAGCCCCCAACGTGACAAGGGGTCCTT|TGGAATTCTCCCTCAACTAGGGCTCCATCG
CAGGGCTAGATACTTAGATTCTTAAATTGG|AACTCAGGGGTCTCAGGATCAACTCTATGA
AGATTCTTAAATTGGCCCAACACAGTAAAT|GGATCAACTCTATGAAATAGCAGGGCTAGA
AACATAATTTCGGGATTATAGCCAACCAGG|GATTCTTAAATTGGGCGATAAGTAACAGAG
ATACTTAGATTCTTCAGGGCTAGATACTTA|AATACCAGAACCTCAGGGCTAGATACTTAG
ACTCCAGGAGACGGGCAACTCAGGGGTCTC|TCAAGTTTCATTGGTCCAAGCGCCATTGAG
AAGGCAGGGCTAGATACTTAGATTCTTAAA|AGCAGGGCTAGATACTTAGATTCTTAAATT
AGATTCTTAAATTGGAAATTGGGCGTAGCG|GATTCTCAGGGCTAGATACTTAGATTCTTA
TAACGTCCACCCCAAGGCAGGGCTAGATAC|TACGCAGAACTGAAGCAGGGCTAGATACTT
ATTCTTAAATTGGATCGGAAAAGAACACGG|AAATCGCAGCAGAGTGCTAACGTCCACCCC
CACCGTGTCTAAGTGGAACCAACACTCCAA|ATTCACGCCTCGGAGTAGCAGGTGCTGCGG
TGGCCCAACACAGTAAATGAGCTAAACATA|TGAAATAGCAGGGCTAGATACTTAGATTCT
GGGCTAGATACTTAGATTCTTAAATTGGCG|AGGACCAGCGAATAACGAGTCACCCGTGTC
GGGCTAGATACTTAGATTCTTAAATTGGAT|GCTAGATACTTAGATTCTTAAATTGGAGTC
ACCAGCCAGCGGTGTCTGCAGGGCTAGATA|CTCAGGGCTAGATACTTAGATTCTTAAATT
AGGGCTAGATACTTAGATTCTTAAATTGGA|CCAACCAGGGCTAGATACTTAGATTCTTAA
CTAAGTGGAACCAACACTCCAAAATCGCAG|CTCGGAGTAGCAGGTGCTGCGGTGGGCAGC
CGTAGCGGCTATCTAAATAGAGAAGCTCTC|ATTCTTAAATTGGTAAATTGGGAGGCAGGG
AACCTCAGGGCTAGATACTTAGATTCTCAG|TCGGAAAAGAACACGGCCGTTGACAGCACC
TGCTCAAAGTCTCCAGGAAGCCCCCAACGT|TTAGATTCTTAAATTGGAATTCTCCCTCAA
AACCGCCACAGCCTCTGAGTCGCACCTCGA|CATTAAGGTCGATAGTAGGCGCTAGAGTGG
TACTTAGATTCTTAAATTGGGCGATAAGTA|AAGCTACCTTACTGTGTAGATGAGGGTAGC
AGATTCTTAAATTGGATTGCTAAGGTCCAT|ATTCTTAAATTGGAGTCCTGTCAGGGCTAG
AGCCGAACTAGAACTCGTGGGCGCCTCACG|GGCAGACGAACCTATATCACCATTGCGCTG
ATTGGGCGATAAGTAACAGAGGACCAGCGA|GTAGATGAGGGTAGCCGCCATCGACCGATC
CACCCCAAGGCAGGGCTAGATACTTAGATT|AACTGAAGCAGGGCTAGATACTTAGATTCT
TTAAATTGGGCGATAAGTAACAGAGGACCA|CTGTGTAGATGAGGGTAGCCGCCATCGACC
CGAACTAGAACTCGTGGGCGCCTCACGTCC|AGACGAACCTATATCACCATTGCGCTGCGG
AAGCAGGGCTAGATACTTAGATTCTTAAAT|AGCCAGCGGTGTCTGCAGGGCTAGATACTT
CGACGCCGACACACACATCAGGGCTAGATA|CATAATTTCGGGATTATAGCCAACCAGGGC
TCTCAGGATCAACTCTATGAAATAGCAGGG|TGAGCCGAACTAGAACTCGTGGGCGCCTCA
GAGCATTCACGCCTCGGAGTAGCAGGTGCT|TGGTGGAGTATAGGATGCTCAAAGTCTCCA
ATACTTAGATTCTCAGGGCTAGATACTTAG|GGCCGTTGACAGCACCATTGCACGAGTAGG
ACGAACCTATATCACCATTGCGCTGCGGCT|GTGCGTATCTCCGCCAGGGACGATGACTAG
TTACAGGGCTAGATACTTAGATTCTTAAAT|CCATCCACCGTGTCTAAGTGGAACCAACAC
CAACGTGACAAGGGGTCCTTACCAGCCAGC|CCTCAACTAGGGCTCCATCGCTCAGGGCTA
AGGGCTAGATACTTAGATTCTTAAATTGGG|CCACCGTGTCTAAGTGGAACCAACACTCCA
ATTGGATTGCTAAGGTCCATGAGCGCTTGC|TGGAGTCCTGTCAGGGCTAGATACTTAGAT
ATCCACCGTGTCTAAGTGGAACCAACACTC|AGCATTCACGCCTCGGAGTAGCAGGTGCTG
TTAGATTCTTAAATTGGGATTCTTAAATTG|AGTGGAACCAACACTCCAAAATCGCAGCAG
CAGGGCTAGATACTTAGATTCTTAAATTGG|CCTCACGTCCAAGCTACCTTACTGTGTAGA
TCTGCAGGGCTAGATACTTAGATTCTTAAA|CTTAGATTCTTAAATTGGCCCAACACAGTA
TGGTCGGCCTGCGTTCTAGCCATCCACCGT|ATGAGCGCTTGCGCTGGCGTGAGCATTCAC
TAAATTGGTAGACAGGGCTAGATACTTAGA|GCATCTAAGCGCCGCTCCGCTAATACCAGA
CGCCATTGAGCCGAACTAGAACTCGTGGGC|GAGTTTCCGGCAGACGAACCTATATCACCA
GATTCTTAAATTGGCGCGCTCACTCCAGGA|ACGAGTCACCCGTGTCGTGGCTCAAGTTTC
ACCAGCGAATAACGAGTCACCCGTGTCGTG|GACCGATCGTCGGTGATTCTATACAACCGC
ATTATAGCCAACCAGGGCTAGATACTTAGA|GCGATAAGTAACAGAGGACCAGCGAATAAC
CAGGGCTAGATACTTAGATTCTCAGGGCTA|AAAGAACACGGCCGTTGACAGCACCATTGC
AAGGTCCATGAGCGCTTGCGCTGGCGTGAG|CAGGGCTAGATACTTAGATTCTTAAATTGG
CTATCTAAATAGAGAAGCTCTCTCGACCGT|ATTGGTAAATTGGGAGGCAGGGCTAGATAC
ACACGGCCGTTGACAGCACCATTGCACGAG|CACCCCAAGGCAGGGCTAGATACTTAGATT
AGGATACCATGACAGAAGTGGATGGTCGGC|TTAAATTGGATTGCTAAGGTCCATGAGCGC
GCTATCTAAATAGAGAAGCTCTCTCGACCG|AATTGGTAAATTGGGAGGCAGGGCTAGATA
GAATTCTCCCTCAACTAGGGCTCCATCGCT|AAATTGGCGCGCTCACTCCAGGAGACGGGC
TTTACGACGCCGACACACACATCAGGGCTA|TAAACATAATTTCGGGATTATAGCCAACCA
ACGTCCACCCCAAGGCAGGGCTAGATACTT|CGCAGAACTGAAGCAGGGCTAGATACTTAG
CAGCTTACGCAGAACTGAAGCAGGGCTAGA|GACAAGGGGTCCTTACCAGCCAGCGGTGTC
TAGATTCTTAAATTGGAGTCCTGTCAGGGC|GGGCTAGATACTTAGATTCTTAAATTGGCG
TAGATTCTCAGGGCTAGATACTTAGATTCT|TTGACAGCACCATTGCACGAGTAGGATACC
GCTAGATACTTAGATTCTTAAATTGGTGGA|CGTTTTACGACGCCGACACACACATCAGGG
TCCAAAATCGCAGCAGAGTGCTAACGTCCA|TGCGGTGGGCAGCATGCAGCTTACGCAGAA
AGCAGGGCTAGATACTTAGATTCTTAAATT|CGCCTCACGTCCAAGCTACCTTACTGTGTA
AGATACTTAGATTCTTAAATTGGAAATTGG|GATACTTAGATTCTCAGGGCTAGATACTTA
TGCACGAGTAGGATACCATGACAGAAGTGG|CTTAGATTCTTAAATTGGATTGCTAAGGTC
CTAGATACTTAGATTCTTAAATTGGAGTCC|GTGTCTGCAGGGCTAGATACTTAGATTCTT
ATACTTAGATTCTTAAATTGGAAATTGGGC|TACTTAGATTCTCAGGGCTAGATACTTAGA
CTTAGATTCTTAAATTGGAGTCCTGTCAGG|CAGGGCTAGATACTTAGATTCTTAAATTGG
GTAAATGAGCTAAACATAATTTCGGGATTA|GCTAGATACTTAGATTCTTAAATTGGGCGA
TCGCAGCAGAGTGCTAACGTCCACCCCAAG|GGCAGCATGCAGCTTACGCAGAACTGAAGC
TAGATTCTTAAATTGGTAGACAGGGCTAGA|AACAGACAGCATCTAAGCGCCGCTCCGCTA
TATGAAATAGCAGGGCTAGATACTTAGATT|CTCGTGGGCGCCTCACGTCCAAGCTACCTT
AATTCTCCCTCAACTAGGGCTCCATCGCTC|AATTGGCGCGCTCACTCCAGGAGACGGGCA
TAGATACTTAGATTCTTAAATTGGAAATTG|AGATACTTAGATTCTCAGGGCTAGATACTT
TAAATGAGCTAAACATAATTTCGGGATTAT|CTAGATACTTAGATTCTTAAATTGGGCGAT
ACGACGCCGACACACACATCAGGGCTAGAT|ACATAATTTCGGGATTATAGCCAACCAGGG
GCCGTTGACAGCACCATTGCACGAGTAGGA|CAAGGCAGGGCTAGATACTTAGATTCTTAA
AAATCGCAGCAGAGTGCTAACGTCCACCCC|GTGGGCAGCATGCAGCTTACGCAGAACTGA
CCGATCGTCGGTGATTCTATACAACCGCCA|AAGTCCCCTAGGGTCATGTCTGCATTAAGG
TTCACGCCTCGGAGTAGCAGGTGCTGCGGT|GAGTATAGGATGCTCAAAGTCTCCAGGAAG
AGCATTCACGCCTCGGAGTAGCAGGTGCTG|GGTGGAGTATAGGATGCTCAAAGTCTCCAG
TGTCTGCAGGGCTAGATACTTAGATTCTTA|TACTTAGATTCTTAAATTGGCCCAACACAG
CAGACAGCATCTAAGCGCCGCTCCGCTAAT|TACTTAGATTCTTAAATTGGGATTCTTAAA
TTACTGTGTAGATGAGGGTAGCCGCCATCG|GGTGTTCAGCATGGACTCCATTTTCTGGTT
GAGTCGCACCTCGAGTTTCCGGCAGACGAA|AGGCGCTAGAGTGGAGGTCTACTGTGTGCG
GCGCCTCACGTCCAAGCTACCTTACTGTGT|CATTGCGCTGCGGCTCTCCTTGGTGTTCAG
GTCGCACCTCGAGTTTCCGGCAGACGAACC|GCGCTAGAGTGGAGGTCTACTGTGTGCGTA
ATTCTTAAATTGGTAAATTGGGAGGCAGGG|ATACCATGACAGAAGTGGATGGTCGGCCTG
GGCAACTCAGGGGTCTCAGGATCAACTCTA|GTCCAAGCGCCATTGAGCCGAACTAGAACT
TGAGTCGCACCTCGAGTTTCCGGCAGACGA|TAGGCGCTAGAGTGGAGGTCTACTGTGTGC
CTTAAATTGGGATTCTTAAATTGGATCGGA|CCAACACTCCAAAATCGCAGCAGAGTGCTA
TTCTTAAATTGGATCGGAAAAGAACACGGC|AATCGCAGCAGAGTGCTAACGTCCACCCCA
TGGTGGAGTATAGGATGCTCAAAGTCTCCA|ATCAGGGCTAGATACTTAGATTCTTAAATT
GGTGATTCTATACAACCGCCACAGCCTCTG|AGGGTCATGTCTGCATTAAGGTCGATAGTA
TCCATCGCTCAGGGCTAGATACTTAGATTC|GAGACGGGCAACTCAGGGGTCTCAGGATCA
TTGGTAAATTGGGAGGCAGGGCTAGATACT|CAGAAGTGGATGGTCGGCCTGCGTTCTAGC
TCGACCGTAACGTATGCTGAACAGACAGCA|CTAGATACTTACAGGGCTAGATACTTAGAT
CTTGCGCTGGCGTGAGCATTCACGCCTCGG|TAGATTCTTAAATTGGTGGAGTATAGGATG
GGCTAGATACTTAGATTCTTAAATTGGTAG|AACGTATGCTGAACAGACAGCATCTAAGCG
CGAACCTATATCACCATTGCGCTGCGGCTC|TGCGTATCTCCGCCAGGGACGATGACTAGT
AGATTCTTAAATTGGTAAATTGGGAGGCAG|GGATACCATGACAGAAGTGGATGGTCGGCC
CCAACGTGACAAGGGGTCCTTACCAGCCAG|CCCTCAACTAGGGCTCCATCGCTCAGGGCT
TACGACGCCGACACACACATCAGGGCTAGA|AACATAATTTCGGGATTATAGCCAACCAGG
GTTTTACGACGCCGACACACACATCAGGGC|GCTAAACATAATTTCGGGATTATAGCCAAC
GCTAGATACTTAGATTCTCAGGGCTAGATA|AACACGGCCGTTGACAGCACCATTGCACGA
AGATTCTTAAATTGGGCGATAAGTAACAGA|ACCTTACTGTGTAGATGAGGGTAGCCGCCA
GACGAACCTATATCACCATTGCGCTGCGGC|TGTGCGTATCTCCGCCAGGGACGATGACTA
TTGGAAATTGGGCGTAGCGGCTATCTAAAT|CTAGATACTTAGATTCTTAAATTGGTAAAT
GAACTGAAGCAGGGCTAGATACTTAGATTC|CTTACCAGCCAGCGGTGTCTGCAGGGCTAG
GCGCTCACTCCAGGAGACGGGCAACTCAGG|CGTGGCTCAAGTTTCATTGGTCCAAGCGCC
CACCATTGCACGAGTAGGATACCATGACAG|TAGATACTTAGATTCTTAAATTGGATTGCT
TAGATTCTTAAATTGGCGTTTTACGACGCC|CCCAACACAGTAAATGAGCTAAACATAATT
CCAAGGCAGGGCTAGATACTTAGATTCTTA|GAAGCAGGGCTAGATACTTAGATTCTTAAA
CTTAGATTCTTAAATTGGAAATTGGGCGTA|TTAGATTCTCAGGGCTAGATACTTAGATTC
GCCTGCGTTCTAGCCATCCACCGTGTCTAA|GCTTGCGCTGGCGTGAGCATTCACGCCTCG
ACTTAGATTCTTAAATTGGAAATTGGGCGT|CTTAGATTCTCAGGGCTAGATACTTAGATT
CTCGGAGTAGCAGGTGCTGCGGTGGGCAGC|GGATGCTCAAAGTCTCCAGGAAGCCCCCAA
AGGGCTAGATACTTAGATTCTTAAATTGGT|GTAACGTATGCTGAACAGACAGCATCTAAG
GTAGCAGGTGCTGCGGTGGGCAGCATGCAG|TCAAAGTCTCCAGGAAGCCCCCAACGTGAC
CTAAACATAATTTCGGGATTATAGCCAACC|TTAGATTCTTAAATTGGGCGATAAGTAACA
AAATTGGCGCGCTCACTCCAGGAGACGGGC|ACCCGTGTCGTGGCTCAAGTTTCATTGGTC
GCGTAGCGGCTATCTAAATAGAGAAGCTCT|GATTCTTAAATTGGTAAATTGGGAGGCAGG
TCAACTCTATGAAATAGCAGGGCTAGATAC|ACTAGAACTCGTGGGCGCCTCACGTCCAAG
GCTCTCTCGACCGTAACGTATGCTGAACAG|GCAGGGCTAGATACTTACAGGGCTAGATAC
CCAACACTCCAAAATCGCAGCAGAGTGCTA|CAGGTGCTGCGGTGGGCAGCATGCAGCTTA
GGCCTGCGTTCTAGCCATCCACCGTGTCTA|CGCTTGCGCTGGCGTGAGCATTCACGCCTC
CGGCTATCTAAATAGAGAAGCTCTCTCGAC|TAAATTGGTAAATTGGGAGGCAGGGCTAGA
TCACGTCCAAGCTACCTTACTGTGTAGATG|CGCTGCGGCTCTCCTTGGTGTTCAGCATGG
CTAGATACTTAGATTCTTAAATTGGCGCGC|ACCAGCGAATAACGAGTCACCCGTGTCGTG
ATACTTAGATTCTTAAATTGGTAAATTGGG|CGAGTAGGATACCATGACAGAAGTGGATGG
ACACAGTAAATGAGCTAAACATAATTTCGG|GCAGGGCTAGATACTTAGATTCTTAAATTG
GGGCTAGATACTTAGATTCTTAAATTGGGA|CACCGTGTCTAAGTGGAACCAACACTCCAA
GGGCTAGATACTTAGATTCTTAAATTGGTG|GGCGTTTTACGACGCCGACACACACATCAG
CCGTGTCTAAGTGGAACCAACACTCCAAAA|TCACGCCTCGGAGTAGCAGGTGCTGCGGTG
GCGCTGGCGTGAGCATTCACGCCTCGGAGT|ATTCTTAAATTGGTGGAGTATAGGATGCTC
TAGGATACCATGACAGAAGTGGATGGTCGG|CTTAAATTGGATTGCTAAGGTCCATGAGCG
ACTCGTGGGCGCCTCACGTCCAAGCTACCT|TATATCACCATTGCGCTGCGGCTCTCCTTG
TAGATACTTAGATTCTTCAGGGCTAGATAC|GCTAATACCAGAACCTCAGGGCTAGATACT
TAAATTGGAAATTGGGCGTAGCGGCTATCT|AGGGCTAGATACTTAGATTCTTAAATTGGT
TATCACCATTGCGCTGCGGCTCTCCTTGGT|TCCGCCAGGGACGATGACTAGTCACATGGG
GACAGCATCTAAGCGCCGCTCCGCTAATAC|CTTAGATTCTTAAATTGGGATTCTTAAATT
GCGATAAGTAACAGAGGACCAGCGAATAAC|TGAGGGTAGCCGCCATCGACCGATCGTCGG
GGATTATAGCCAACCAGGGCTAGATACTTA|GGGCGATAAGTAACAGAGGACCAGCGAATA
AGGGCTAGATACTTAGATTCTTAAATTGGA|GGGCTAGATACTTAGATTCTCAGGGCTAGA
CATTCACGCCTCGGAGTAGCAGGTGCTGCG|TGGAGTATAGGATGCTCAAAGTCTCCAGGA
AATTGGGCGTAGCGGCTATCTAAATAGAGA|TACTTAGATTCTTAAATTGGTAAATTGGGA
ACCGTGTCTAAGTGGAACCAACACTCCAAA|TTCACGCCTCGGAGTAGCAGGTGCTGCGGT
GCCGCTCCGCTAATACCAGAACCTCAGGGC|TTGGGATTCTTAAATTGGATCGGAAAAGAA
GATACTTAGATTCTTAAATTGGTAAATTGG|ACGAGTAGGATACCATGACAGAAGTGGATG
GATACTTAGATTCTTAAATTGGATTGCTAA|TACTTAGATTCTTAAATTGGAGTCCTGTCA
CTTAGATTCTTAAATTGGTGGAGTATAGGA|GACGCCGACACACACATCAGGGCTAGATAC
CATTGAGCCGAACTAGAACTCGTGGGCGCC|TTTCCGGCAGACGAACCTATATCACCATTG
TTGGCGTTTTACGACGCCGACACACACATC|AATGAGCTAAACATAATTTCGGGATTATAG
ACACATCAGGGCTAGATACTTAGATTCTTA|ATTATAGCCAACCAGGGCTAGATACTTAGA
CTCAGGATCAACTCTATGAAATAGCAGGGC|GAGCCGAACTAGAACTCGTGGGCGCCTCAC
GAGCCGAACTAGAACTCGTGGGCGCCTCAC|CGGCAGACGAACCTATATCACCATTGCGCT
ACTCCAAAATCGCAGCAGAGTGCTAACGTC|GCTGCGGTGGGCAGCATGCAGCTTACGCAG
AGATTCTTAAATTGGGATTCTTAAATTGGA|TGGAACCAACACTCCAAAATCGCAGCAGAG
ATCGCTCAGGGCTAGATACTTAGATTCTTA|ACGGGCAACTCAGGGGTCTCAGGATCAACT
TAAGGTCCATGAGCGCTTGCGCTGGCGTGA|TCAGGGCTAGATACTTAGATTCTTAAATTG
ACTTAGATTCTTAAATTGGCGTTTTACGAC|TGGCCCAACACAGTAAATGAGCTAAACATA
CCGGCAGACGAACCTATATCACCATTGCGC|CTACTGTGTGCGTATCTCCGCCAGGGACGA
CAGACGAACCTATATCACCATTGCGCTGCG|TGTGTGCGTATCTCCGCCAGGGACGATGAC
CTTAAATTGGTAGACAGGGCTAGATACTTA|CAGCATCTAAGCGCCGCTCCGCTAATACCA
CGGCCGTTGACAGCACCATTGCACGAGTAG|CCCAAGGCAGGGCTAGATACTTAGATTCTT
GATCGTCGGTGATTCTATACAACCGCCACA|GTCCCCTAGGGTCATGTCTGCATTAAGGTC
ATACAACCGCCACAGCCTCTGAGTCGCACC|TCTGCATTAAGGTCGATAGTAGGCGCTAGA
AGGGCTAGATACTTAGATTCTTCAGGGCTA|GCTCCGCTAATACCAGAACCTCAGGGCTAG
TAGATACTTAGATTCTTAAATTGGATTGCT|GATACTTAGATTCTTAAATTGGAGTCCTGT
CATCCACCGTGTCTAAGTGGAACCAACACT|GAGCATTCACGCCTCGGAGTAGCAGGTGCT
CCTTACCAGCCAGCGGTGTCTGCAGGGCTA|ATCGCTCAGGGCTAGATACTTAGATTCTTA
TAAATTGGCGTTTTACGACGCCGACACACA|AGTAAATGAGCTAAACATAATTTCGGGATT
AGCACCATTGCACGAGTAGGATACCATGAC|GCTAGATACTTAGATTCTTAAATTGGATTG
ATTGGCCCAACACAGTAAATGAGCTAAACA|TATGAAATAGCAGGGCTAGATACTTAGATT
TCCATGAGCGCTTGCGCTGGCGTGAGCATT|GCTAGATACTTAGATTCTTAAATTGGTGGA
AGGGGTCCTTACCAGCCAGCGGTGTCTGCA|GGCTCCATCGCTCAGGGCTAGATACTTAGA
TGGTAAATTGGGAGGCAGGGCTAGATACTT|AGAAGTGGATGGTCGGCCTGCGTTCTAGCC
CGTGGCTCAAGTTTCATTGGTCCAAGCGCC|CCGCCACAGCCTCTGAGTCGCACCTCGAGT
GCAGAGTGCTAACGTCCACCCCAAGGCAGG|CATGCAGCTTACGCAGAACTGAAGCAGGGC
TTAAATTGGATCGGAAAAGAACACGGCCGT|CGCAGCAGAGTGCTAACGTCCACCCCAAGG
AGCCATCCACCGTGTCTAAGTGGAACCAAC|CGTGAGCATTCACGCCTCGGAGTAGCAGGT
GTAACAGAGGACCAGCGAATAACGAGTCAC|AGCCGCCATCGACCGATCGTCGGTGATTCT
GTGCTGCGGTGGGCAGCATGCAGCTTACGC|CTCCAGGAAGCCCCCAACGTGACAAGGGGT
AGATACTTAGATTCTTAAATTGGCGCGCTC|CAGCGAATAACGAGTCACCCGTGTCGTGGC
GGAGACGGGCAACTCAGGGGTCTCAGGATC|TTCATTGGTCCAAGCGCCATTGAGCCGAAC
GGGCTAGATACTTAGATTCTTAAATTGGTA|CATTGCACGAGTAGGATACCATGACAGAAG
AACTGAAGCAGGGCTAGATACTTAGATTCT|TTACCAGCCAGCGGTGTCTGCAGGGCTAGA
ACCAACACTCCAAAATCGCAGCAGAGTGCT|GCAGGTGCTGCGGTGGGCAGCATGCAGCTT
CTAGATACTTAGATTCTTAAATTGGCGTTT|TTAAATTGGCCCAACACAGTAAATGAGCTA
ATTCTTAAATTGGCCCAACACAGTAAATGA|ATCAACTCTATGAAATAGCAGGGCTAGATA
CTTAGATTCTTAAATTGGAATTCTCCCTCA|TAGATACTTAGATTCTTAAATTGGCGCGCT
CGCCTCGGAGTAGCAGGTGCTGCGGTGGGC|ATAGGATGCTCAAAGTCTCCAGGAAGCCCC
AGATACTTAGATTCTTAAATTGGATTGCTA|ATACTTAGATTCTTAAATTGGAGTCCTGTC
GCTAGATACTTAGATTCTTAAATTGGTAAA|TTGCACGAGTAGGATACCATGACAGAAGTG
ATTGCTAAGGTCCATGAGCGCTTGCGCTGG|TCCTGTCAGGGCTAGATACTTAGATTCTTA
ATTCTTAAATTGGAAATTGGGCGTAGCGGC|TTCTCAGGGCTAGATACTTAGATTCTTAAA
ACTTAGATTCTTAAATTGGCGCGCTCACTC|GAATAACGAGTCACCCGTGTCGTGGCTCAA
CACGGCCGTTGACAGCACCATTGCACGAGT|ACCCCAAGGCAGGGCTAGATACTTAGATTC
GCGGTGGGCAGCATGCAGCTTACGCAGAAC|GGAAGCCCCCAACGTGACAAGGGGTCCTTA
TGGGATTCTTAAATTGGATCGGAAAAGAAC|TCCAAAATCGCAGCAGAGTGCTAACGTCCA
GATACCATGACAGAAGTGGATGGTCGGCCT|AAATTGGATTGCTAAGGTCCATGAGCGCTT
AGTATAGGATGCTCAAAGTCTCCAGGAAGC|GCTAGATACTTAGATTCTTAAATTGGAATT
TTGGAATTCTCCCTCAACTAGGGCTCCATC|CTTAAATTGGCGCGCTCACTCCAGGAGACG
TCGCTCAGGGCTAGATACTTAGATTCTTAA|CGGGCAACTCAGGGGTCTCAGGATCAACTC
ATTCTTAAATTGGAGTCCTGTCAGGGCTAG|CTAGATACTTAGATTCTTAAATTGGCGTTT
GACCGTAACGTATGCTGAACAGACAGCATC|AGATACTTACAGGGCTAGATACTTAGATTC
TACCTTACTGTGTAGATGAGGGTAGCCGCC|CCTTGGTGTTCAGCATGGACTCCATTTTCT
AGCCAGCGGTGTCTGCAGGGCTAGATACTT|AGGGCTAGATACTTAGATTCTTAAATTGGC
TTACGACGCCGACACACACATCAGGGCTAG|AAACATAATTTCGGGATTATAGCCAACCAG
TTAGATTCTTCAGGGCTAGATACTTAGATT|CCAGAACCTCAGGGCTAGATACTTAGATTC
TGTCGTGGCTCAAGTTTCATTGGTCCAAGC|CAACCGCCACAGCCTCTGAGTCGCACCTCG
TTAGATTCTTAAATTGGTAAATTGGGAGGC|TAGGATACCATGACAGAAGTGGATGGTCGG
ATTGGTGGAGTATAGGATGCTCAAAGTCTC|ACATCAGGGCTAGATACTTAGATTCTTAAA
AAATTGGAAATTGGGCGTAGCGGCTATCTA|GGGCTAGATACTTAGATTCTTAAATTGGTA
AGACGAACCTATATCACCATTGCGCTGCGG|GTGTGCGTATCTCCGCCAGGGACGATGACT
GGTCAAGAAGGACTCACAGGGCTAGATACT|GAGAAGCTCTCTCGACCGTAACGTATGCTG
ATGCTGAACAGACAGCATCTAAGCGCCGCT|GGGCTAGATACTTAGATTCTTAAATTGGGA
GACAGCACCATTGCACGAGTAGGATACCAT|AGGGCTAGATACTTAGATTCTTAAATTGGA
GGGCTCCATCGCTCAGGGCTAGATACTTAG|CCAGGAGACGGGCAACTCAGGGGTCTCAGG
TTGGATCGGAAAAGAACACGGCCGTTGACA|CAGAGTGCTAACGTCCACCCCAAGGCAGGG
CAGGGCTAGATACTTAGATTCTTAAATTGG|AGAGGACCAGCGAATAACGAGTCACCCGTG
TCACAGGGCTAGATACTTAGATTCTTAAAT|GACCGTAACGTATGCTGAACAGACAGCATC
CAGGGCTAGATACTTAGATTCTTCAGGGCT|CGCTCCGCTAATACCAGAACCTCAGGGCTA
ATTGGCGCGCTCACTCCAGGAGACGGGCAA|CCGTGTCGTGGCTCAAGTTTCATTGGTCCA
CAACACAGTAAATGAGCTAAACATAATTTC|TAGCAGGGCTAGATACTTAGATTCTTAAAT
TTTTACGACGCCGACACACACATCAGGGCT|CTAAACATAATTTCGGGATTATAGCCAACC
AAGCTCTCTCGACCGTAACGTATGCTGAAC|AGGCAGGGCTAGATACTTACAGGGCTAGAT
TAGAACTCGTGGGCGCCTCACGTCCAAGCT|AACCTATATCACCATTGCGCTGCGGCTCTC
ATACTTAGATTCTTAAATTGGAGTCCTGTC|CTGCAGGGCTAGATACTTAGATTCTTAAAT
TTGGGATTCTTAAATTGGATCGGAAAAGAA|CTCCAAAATCGCAGCAGAGTGCTAACGTCC
ACTTAGATTCTTAAATTGGGATTCTTAAAT|TAAGTGGAACCAACACTCCAAAATCGCAGC
ATCAACTCTATGAAATAGCAGGGCTAGATA|AACTAGAACTCGTGGGCGCCTCACGTCCAA
TACTTAGATTCTTAAATTGGTAGACAGGGC|GCTGAACAGACAGCATCTAAGCGCCGCTCC
GATTCTTAAATTGGATTGCTAAGGTCCATG|TTCTTAAATTGGAGTCCTGTCAGGGCTAGA
TTAGATTCTTAAATTGGTAGACAGGGCTAG|GAACAGACAGCATCTAAGCGCCGCTCCGCT
TATGCTGAACAGACAGCATCTAAGCGCCGC|AGGGCTAGATACTTAGATTCTTAAATTGGG
GTCAAGAAGGACTCACAGGGCTAGATACTT|AGAAGCTCTCTCGACCGTAACGTATGCTGA
TACTTAGATTCTTAAATTGGAAATTGGGCG|ACTTAGATTCTCAGGGCTAGATACTTAGAT
TCAGGGCTAGATACTTAGATTCTTAAATTG|AGCCAACCAGGGCTAGATACTTAGATTCTT
TGCGCTGGCGTGAGCATTCACGCCTCGGAG|GATTCTTAAATTGGTGGAGTATAGGATGCT
GATACTTACAGGGCTAGATACTTAGATTCT|TCTAGCCATCCACCGTGTCTAAGTGGAACC
TCAAGAAGGACTCACAGGGCTAGATACTTA|GAAGCTCTCTCGACCGTAACGTATGCTGAA
CCCAAGGCAGGGCTAGATACTTAGATTCTT|TGAAGCAGGGCTAGATACTTAGATTCTTAA
AGATACTTAGATTCTTAAATTGGGATTCTT|TGTCTAAGTGGAACCAACACTCCAAAATCG
CATAATTTCGGGATTATAGCCAACCAGGGC|TTCTTAAATTGGGCGATAAGTAACAGAGGA
TCTGAGTCGCACCTCGAGTTTCCGGCAGAC|AGTAGGCGCTAGAGTGGAGGTCTACTGTGT
AGTAGGATACCATGACAGAAGTGGATGGTC|TTCTTAAATTGGATTGCTAAGGTCCATGAG
GCCTCTGAGTCGCACCTCGAGTTTCCGGCA|GATAGTAGGCGCTAGAGTGGAGGTCTACTG
CAGGGCTAGATACTTAGATTCTTAAATTGG|GCCAACCAGGGCTAGATACTTAGATTCTTA
AGACAGGGCTAGATACTTAGATTCTTCAGG|CGCCGCTCCGCTAATACCAGAACCTCAGGG
TCTAAGTGGAACCAACACTCCAAAATCGCA|CCTCGGAGTAGCAGGTGCTGCGGTGGGCAG
CAGGATCAACTCTATGAAATAGCAGGGCTA|GCCGAACTAGAACTCGTGGGCGCCTCACGT
AGGTGCTGCGGTGGGCAGCATGCAGCTTAC|GTCTCCAGGAAGCCCCCAACGTGACAAGGG
GCTAGATACTTAGATTCTTAAATTGGAGTC|GGTGTCTGCAGGGCTAGATACTTAGATTCT
AGATTCTTAAATTGGCGTTTTACGACGCCG|CCAACACAGTAAATGAGCTAAACATAATTT
CTAAGCGCCGCTCCGCTAATACCAGAACCT|CTTAAATTGGGATTCTTAAATTGGATCGGA
GGGCGTAGCGGCTATCTAAATAGAGAAGCT|TAGATTCTTAAATTGGTAAATTGGGAGGCA
TAGATTCTTAAATTGGATTGCTAAGGTCCA|GATTCTTAAATTGGAGTCCTGTCAGGGCTA
TAAGCGCCGCTCCGCTAATACCAGAACCTC|TTAAATTGGGATTCTTAAATTGGATCGGAA
ACAACCGCCACAGCCTCTGAGTCGCACCTC|TGCATTAAGGTCGATAGTAGGCGCTAGAGT
CAGCATGCAGCTTACGCAGAACTGAAGCAG|CCAACGTGACAAGGGGTCCTTACCAGCCAG
AACGTCCACCCCAAGGCAGGGCTAGATACT|ACGCAGAACTGAAGCAGGGCTAGATACTTA
TTTCATTGGTCCAAGCGCCATTGAGCCGAA|TCTGAGTCGCACCTCGAGTTTCCGGCAGAC
AAAAGAACACGGCCGTTGACAGCACCATTG|AACGTCCACCCCAAGGCAGGGCTAGATACT
TGGATCGGAAAAGAACACGGCCGTTGACAG|AGAGTGCTAACGTCCACCCCAAGGCAGGGC
ATTGGGATTCTTAAATTGGATCGGAAAAGA|ACTCCAAAATCGCAGCAGAGTGCTAACGTC
ACTTAGATTCTTAAATTGGTAGACAGGGCT|CTGAACAGACAGCATCTAAGCGCCGCTCCG
CTGAAGCAGGGCTAGATACTTAGATTCTTA|ACCAGCCAGCGGTGTCTGCAGGGCTAGATA
AGAGAAGCTCTCTCGACCGTAACGTATGCT|TGGGAGGCAGGGCTAGATACTTACAGGGCT
CGTTTTACGACGCCGACACACACATCAGGG|AGCTAAACATAATTTCGGGATTATAGCCAA
CGGCAGACGAACCTATATCACCATTGCGCT|TACTGTGTGCGTATCTCCGCCAGGGACGAT
CAGAACCTCAGGGCTAGATACTTAGATTCT|GGATCGGAAAAGAACACGGCCGTTGACAGC
CGACCGTAACGTATGCTGAACAGACAGCAT|TAGATACTTACAGGGCTAGATACTTAGATT
GACACACACATCAGGGCTAGATACTTAGAT|TCGGGATTATAGCCAACCAGGGCTAGATAC
CCGCTCCGCTAATACCAGAACCTCAGGGCT|TGGGATTCTTAAATTGGATCGGAAAAGAAC
TAAACATAATTTCGGGATTATAGCCAACCA|TAGATTCTTAAATTGGGCGATAAGTAACAG
TACGCAGAACTGAAGCAGGGCTAGATACTT|GGGGTCCTTACCAGCCAGCGGTGTCTGCAG
CAGCGAATAACGAGTCACCCGTGTCGTGGC|CCGATCGTCGGTGATTCTATACAACCGCCA
ACGGCCGTTGACAGCACCATTGCACGAGTA|CCCCAAGGCAGGGCTAGATACTTAGATTCT
TAGATACTTAGATTCTTAAATTGGTAGACA|GTATGCTGAACAGACAGCATCTAAGCGCCG
CGGAGTAGCAGGTGCTGCGGTGGGCAGCAT|ATGCTCAAAGTCTCCAGGAAGCCCCCAACG
GGTAGACAGGGCTAGATACTTAGATTCTTC|AAGCGCCGCTCCGCTAATACCAGAACCTCA
ACAAGGGGTCCTTACCAGCCAGCGGTGTCT|TAGGGCTCCATCGCTCAGGGCTAGATACTT
GAAATAGCAGGGCTAGATACTTAGATTCTT|GTGGGCGCCTCACGTCCAAGCTACCTTACT
GACCAGCGAATAACGAGTCACCCGTGTCGT|CGACCGATCGTCGGTGATTCTATACAACCG
GCTCAAAGTCTCCAGGAAGCCCCCAACGTG|TAGATTCTTAAATTGGAATTCTCCCTCAAC
AGAGTGCTAACGTCCACCCCAAGGCAGGGC|TGCAGCTTACGCAGAACTGAAGCAGGGCTA
AACGTATGCTGAACAGACAGCATCTAAGCG|TTACAGGGCTAGATACTTAGATTCTTAAAT
GATTCTTAAATTGGTGGAGTATAGGATGCT|CCGACACACACATCAGGGCTAGATACTTAG
TTATAGCCAACCAGGGCTAGATACTTAGAT|CGATAAGTAACAGAGGACCAGCGAATAACG
CTTAGATTCTTAAATTGGGCGATAAGTAAC|GCTACCTTACTGTGTAGATGAGGGTAGCCG
GCCATCCACCGTGTCTAAGTGGAACCAACA|GTGAGCATTCACGCCTCGGAGTAGCAGGTG
TCGACCGATCGTCGGTGATTCTATACAACC|GTTGAAGTCCCCTAGGGTCATGTCTGCATT
CCACAGCCTCTGAGTCGCACCTCGAGTTTC|AGGTCGATAGTAGGCGCTAGAGTGGAGGTC
GTCCTGTCAGGGCTAGATACTTAGATTCTT|TCTTAAATTGGCGTTTTACGACGCCGACAC
TCAGGGGTCTCAGGATCAACTCTATGAAAT|GCGCCATTGAGCCGAACTAGAACTCGTGGG
AGGGTAGCCGCCATCGACCGATCGTCGGTG|ACTCCATTTTCTGGTTGAAGTCCCCTAGGG
GTTCTAGCCATCCACCGTGTCTAAGTGGAA|GCTGGCGTGAGCATTCACGCCTCGGAGTAG
AAATGAGCTAAACATAATTTCGGGATTATA|TAGATACTTAGATTCTTAAATTGGGCGATA
GTCTGCAGGGCTAGATACTTAGATTCTTAA|ACTTAGATTCTTAAATTGGCCCAACACAGT
TCGGGATTATAGCCAACCAGGGCTAGATAC|ATTGGGCGATAAGTAACAGAGGACCAGCGA
AGTAACAGAGGACCAGCGAATAACGAGTCA|TAGCCGCCATCGACCGATCGTCGGTGATTC
TCTTAAATTGGCCCAACACAGTAAATGAGC|CAACTCTATGAAATAGCAGGGCTAGATACT
AGATTCTTCAGGGCTAGATACTTAGATTCT|AGAACCTCAGGGCTAGATACTTAGATTCTC
CTTCAGGGCTAGATACTTAGATTCTTAAAT|CTCAGGGCTAGATACTTAGATTCTCAGGGC
AGATACTTAGATTCTCAGGGCTAGATACTT|ACGGCCGTTGACAGCACCATTGCACGAGTA
TTACGCAGAACTGAAGCAGGGCTAGATACT|AGGGGTCCTTACCAGCCAGCGGTGTCTGCA
AATAGCAGGGCTAGATACTTAGATTCTTAA|GGGCGCCTCACGTCCAAGCTACCTTACTGT
CTCCAAAATCGCAGCAGAGTGCTAACGTCC|CTGCGGTGGGCAGCATGCAGCTTACGCAGA
TATATCACCATTGCGCTGCGGCTCTCCTTG|TCTCCGCCAGGGACGATGACTAGTCACATG
TGGGCGATAAGTAACAGAGGACCAGCGAAT|AGATGAGGGTAGCCGCCATCGACCGATCGT
GAGACGGGCAACTCAGGGGTCTCAGGATCA|TCATTGGTCCAAGCGCCATTGAGCCGAACT
TAACAGAGGACCAGCGAATAACGAGTCACC|GCCGCCATCGACCGATCGTCGGTGATTCTA
GTCCAAGCGCCATTGAGCCGAACTAGAACT|GCACCTCGAGTTTCCGGCAGACGAACCTAT
CTTACAGGGCTAGATACTTAGATTCTTAAA|GCCATCCACCGTGTCTAAGTGGAACCAACA
TCTCCAGGAAGCCCCCAACGTGACAAGGGG|TAAATTGGAATTCTCCCTCAACTAGGGCTC
ACAGTAAATGAGCTAAACATAATTTCGGGA|AGGGCTAGATACTTAGATTCTTAAATTGGG
CCAGCGGTGTCTGCAGGGCTAGATACTTAG|GGCTAGATACTTAGATTCTTAAATTGGCCC
AATAGAGAAGCTCTCTCGACCGTAACGTAT|AATTGGGAGGCAGGGCTAGATACTTACAGG
CTTAGATTCTCAGGGCTAGATACTTAGATT|CGTTGACAGCACCATTGCACGAGTAGGATA
CAGGAGACGGGCAACTCAGGGGTCTCAGGA|GTTTCATTGGTCCAAGCGCCATTGAGCCGA
TTAAATTGGATTGCTAAGGTCCATGAGCGC|AAATTGGAGTCCTGTCAGGGCTAGATACTT
TGACAAGGGGTCCTTACCAGCCAGCGGTGT|ACTAGGGCTCCATCGCTCAGGGCTAGATAC
TAGATACTTAGATTCTTAAATTGGAGTCCT|TGTCTGCAGGGCTAGATACTTAGATTCTTA
CCTCAACTAGGGCTCCATCGCTCAGGGCTA|GCGCTCACTCCAGGAGACGGGCAACTCAGG
GAGGCAGGGCTAGATACTTACAGGGCTAGA|GTCGGCCTGCGTTCTAGCCATCCACCGTGT
CAGGGCTAGATACTTACAGGGCTAGATACT|GCCTGCGTTCTAGCCATCCACCGTGTCTAA
TCGTGGGCGCCTCACGTCCAAGCTACCTTA|TATCACCATTGCGCTGCGGCTCTCCTTGGT
GGCGTAGCGGCTATCTAAATAGAGAAGCTC|AGATTCTTAAATTGGTAAATTGGGAGGCAG
CTTAAATTGGATCGGAAAAGAACACGGCCG|TCGCAGCAGAGTGCTAACGTCCACCCCAAG
CATGAGCGCTTGCGCTGGCGTGAGCATTCA|TAGATACTTAGATTCTTAAATTGGTGGAGT
AGCCTCTGAGTCGCACCTCGAGTTTCCGGC|CGATAGTAGGCGCTAGAGTGGAGGTCTACT
ATTCTTAAATTGGAATTCTCCCTCAACTAG|ACTTAGATTCTTAAATTGGCGCGCTCACTC
TACTTAGATTCTTAAATTGGCGTTTTACGA|TTGGCCCAACACAGTAAATGAGCTAAACAT
TCAACTAGGGCTCCATCGCTCAGGGCTAGA|GCTCACTCCAGGAGACGGGCAACTCAGGGG
GTGGGCGCCTCACGTCCAAGCTACCTTACT|TCACCATTGCGCTGCGGCTCTCCTTGGTGT
GTGAGCATTCACGCCTCGGAGTAGCAGGTG|ATTGGTGGAGTATAGGATGCTCAAAGTCTC
TAGATTCTTCAGGGCTAGATACTTAGATTC|CAGAACCTCAGGGCTAGATACTTAGATTCT
CTAGATACTTAGATTCTTAAATTGGAAATT|TAGATACTTAGATTCTCAGGGCTAGATACT
TGGCGTTTTACGACGCCGACACACACATCA|ATGAGCTAAACATAATTTCGGGATTATAGC
CGTGACAAGGGGTCCTTACCAGCCAGCGGT|CAACTAGGGCTCCATCGCTCAGGGCTAGAT
AGTCTCCAGGAAGCCCCCAACGTGACAAGG|CTTAAATTGGAATTCTCCCTCAACTAGGGC
TAGATGAGGGTAGCCGCCATCGACCGATCG|GCATGGACTCCATTTTCTGGTTGAAGTCCC
CAGAGGACCAGCGAATAACGAGTCACCCGT|GCCATCGACCGATCGTCGGTGATTCTATAC
AGATTCTTAAATTGGCGCGCTCACTCCAGG|AACGAGTCACCCGTGTCGTGGCTCAAGTTT
CAGGGGTCTCAGGATCAACTCTATGAAATA|CGCCATTGAGCCGAACTAGAACTCGTGGGC
AATTGGCGCGCTCACTCCAGGAGACGGGCA|CCCGTGTCGTGGCTCAAGTTTCATTGGTCC
ACTTACAGGGCTAGATACTTAGATTCTTAA|AGCCATCCACCGTGTCTAAGTGGAACCAAC
ATAATTTCGGGATTATAGCCAACCAGGGCT|TCTTAAATTGGGCGATAAGTAACAGAGGAC
GATACTTAGATTCTTAAATTGGCGTTTTAC|AATTGGCCCAACACAGTAAATGAGCTAAAC
CACGCCTCGGAGTAGCAGGTGCTGCGGTGG|GTATAGGATGCTCAAAGTCTCCAGGAAGCC
AGGCAGGGCTAGATACTTACAGGGCTAGAT|TCGGCCTGCGTTCTAGCCATCCACCGTGTC
GAAATTGGGCGTAGCGGCTATCTAAATAGA|GATACTTAGATTCTTAAATTGGTAAATTGG
GGAATTCTCCCTCAACTAGGGCTCCATCGC|TAAATTGGCGCGCTCACTCCAGGAGACGGG
TGGCGCGCTCACTCCAGGAGACGGGCAACT|GTGTCGTGGCTCAAGTTTCATTGGTCCAAG
GCTAGATACTTAGATTCTTAAATTGGAATT|ACCAGGGCTAGATACTTAGATTCTTAAATT
CGCCATCGACCGATCGTCGGTGATTCTATA|TTCTGGTTGAAGTCCCCTAGGGTCATGTCT
TATCTAAATAGAGAAGCTCTCTCGACCGTA|TTGGTAAATTGGGAGGCAGGGCTAGATACT
CCCTCAACTAGGGCTCCATCGCTCAGGGCT|CGCGCTCACTCCAGGAGACGGGCAACTCAG
GGCGTGAGCATTCACGCCTCGGAGTAGCAG|TAAATTGGTGGAGTATAGGATGCTCAAAGT
TTCCGGCAGACGAACCTATATCACCATTGC|GTCTACTGTGTGCGTATCTCCGCCAGGGAC
AAATTGGGATTCTTAAATTGGATCGGAAAA|ACACTCCAAAATCGCAGCAGAGTGCTAACG
TAGATACTTAGATTCTTAAATTGGCGTTTT|TAAATTGGCCCAACACAGTAAATGAGCTAA
AGTGCTAACGTCCACCCCAAGGCAGGGCTA|CAGCTTACGCAGAACTGAAGCAGGGCTAGA
TCCAAGCGCCATTGAGCCGAACTAGAACTC|CACCTCGAGTTTCCGGCAGACGAACCTATA
GCAGGGCTAGATACTTACAGGGCTAGATAC|GGCCTGCGTTCTAGCCATCCACCGTGTCTA
TAGATACTTAGATTCTTAAATTGGCGCGCT|CCAGCGAATAACGAGTCACCCGTGTCGTGG
TCTTAAATTGGCGTTTTACGACGCCGACAC|CACAGTAAATGAGCTAAACATAATTTCGGG
AAGCGCCATTGAGCCGAACTAGAACTCGTG|CTCGAGTTTCCGGCAGACGAACCTATATCA
AAAATCGCAGCAGAGTGCTAACGTCCACCC|GGTGGGCAGCATGCAGCTTACGCAGAACTG
GCACCTCGAGTTTCCGGCAGACGAACCTAT|CTAGAGTGGAGGTCTACTGTGTGCGTATCT
CTTAGATTCTTAAATTGGCCCAACACAGTA|TCAGGATCAACTCTATGAAATAGCAGGGCT
TCGTCGGTGATTCTATACAACCGCCACAGC|CCCCTAGGGTCATGTCTGCATTAAGGTCGA
GATTCTATACAACCGCCACAGCCTCTGAGT|GTCATGTCTGCATTAAGGTCGATAGTAGGC
TACTTAGATTCTTAAATTGGTAAATTGGGA|GAGTAGGATACCATGACAGAAGTGGATGGT
CATCAGGGCTAGATACTTAGATTCTTAAAT|ATAGCCAACCAGGGCTAGATACTTAGATTC
AGCGAATAACGAGTCACCCGTGTCGTGGCT|CGATCGTCGGTGATTCTATACAACCGCCAC
TTTCCGGCAGACGAACCTATATCACCATTG|GGTCTACTGTGTGCGTATCTCCGCCAGGGA
GGTAAATTGGGAGGCAGGGCTAGATACTTA|GAAGTGGATGGTCGGCCTGCGTTCTAGCCA
GACGCCGACACACACATCAGGGCTAGATAC|ATAATTTCGGGATTATAGCCAACCAGGGCT
GTAAATTGGGAGGCAGGGCTAGATACTTAC|AAGTGGATGGTCGGCCTGCGTTCTAGCCAT
CTACCTTACTGTGTAGATGAGGGTAGCCGC|TCCTTGGTGTTCAGCATGGACTCCATTTTC
GCTAGATACTTAGATTCTTAAATTGGCGTT|CTTAAATTGGCCCAACACAGTAAATGAGCT
AAGTAACAGAGGACCAGCGAATAACGAGTC|GTAGCCGCCATCGACCGATCGTCGGTGATT
TCGGAAAAGAACACGGCCGTTGACAGCACC|TGCTAACGTCCACCCCAAGGCAGGGCTAGA
GGGCTAGATACTTAGATTCTCAGGGCTAGA|AGAACACGGCCGTTGACAGCACCATTGCAC
TTCTCCCTCAACTAGGGCTCCATCGCTCAG|TTGGCGCGCTCACTCCAGGAGACGGGCAAC
GCGCCATTGAGCCGAACTAGAACTCGTGGG|CGAGTTTCCGGCAGACGAACCTATATCACC
CAGGGCTAGATACTTAGATTCTTAAATTGG|ACCATTGCACGAGTAGGATACCATGACAGA
GTGACAAGGGGTCCTTACCAGCCAGCGGTG|AACTAGGGCTCCATCGCTCAGGGCTAGATA
TTCTTAAATTGGTAAATTGGGAGGCAGGGC|TACCATGACAGAAGTGGATGGTCGGCCTGC
ATTCTCAGGGCTAGATACTTAGATTCTTAA|ACAGCACCATTGCACGAGTAGGATACCATG
GGGCAACTCAGGGGTCTCAGGATCAACTCT|GGTCCAAGCGCCATTGAGCCGAACTAGAAC
AGATTCTTAAATTGGAATTCTCCCTCAACT|ATACTTAGATTCTTAAATTGGCGCGCTCAC
TTGGTGGAGTATAGGATGCTCAAAGTCTCC|CATCAGGGCTAGATACTTAGATTCTTAAAT
AGAAGCTCTCTCGACCGTAACGTATGCTGA|GGAGGCAGGGCTAGATACTTACAGGGCTAG
GTTTCCGGCAGACGAACCTATATCACCATT|AGGTCTACTGTGTGCGTATCTCCGCCAGGG
ACGTGACAAGGGGTCCTTACCAGCCAGCGG|TCAACTAGGGCTCCATCGCTCAGGGCTAGA
GGTAGCCGCCATCGACCGATCGTCGGTGAT|TCCATTTTCTGGTTGAAGTCCCCTAGGGTC
GTGGATGGTCGGCCTGCGTTCTAGCCATCC|GGTCCATGAGCGCTTGCGCTGGCGTGAGCA
TTACCAGCCAGCGGTGTCTGCAGGGCTAGA|CGCTCAGGGCTAGATACTTAGATTCTTAAA
AAGTGGAACCAACACTCCAAAATCGCAGCA|CGGAGTAGCAGGTGCTGCGGTGGGCAGCAT
GAACTCGTGGGCGCCTCACGTCCAAGCTAC|CCTATATCACCATTGCGCTGCGGCTCTCCT
TAGATTCTTAAATTGGCGCGCTCACTCCAG|TAACGAGTCACCCGTGTCGTGGCTCAAGTT
GCTAGATACTTAGATTCTTAAATTGGGATT|CCGTGTCTAAGTGGAACCAACACTCCAAAA
TAGATACTTACAGGGCTAGATACTTAGATT|GTTCTAGCCATCCACCGTGTCTAAGTGGAA
GTGTCTGCAGGGCTAGATACTTAGATTCTT|ATACTTAGATTCTTAAATTGGCCCAACACA
GGCTAGATACTTAGATTCTTAAATTGGAGT|CGGTGTCTGCAGGGCTAGATACTTAGATTC
CCACCGTGTCTAAGTGGAACCAACACTCCA|CATTCACGCCTCGGAGTAGCAGGTGCTGCG
GGCAGGGCTAGATACTTACAGGGCTAGATA|CGGCCTGCGTTCTAGCCATCCACCGTGTCT
ACGAGTCACCCGTGTCGTGGCTCAAGTTTC|GGTGATTCTATACAACCGCCACAGCCTCTG
GCCATTGAGCCGAACTAGAACTCGTGGGCG|AGTTTCCGGCAGACGAACCTATATCACCAT
TCTTAAATTGGTAGACAGGGCTAGATACTT|ACAGCATCTAAGCGCCGCTCCGCTAATACC
CCTCTGAGTCGCACCTCGAGTTTCCGGCAG|ATAGTAGGCGCTAGAGTGGAGGTCTACTGT
ATTGGTAGACAGGGCTAGATACTTAGATTC|TCTAAGCGCCGCTCCGCTAATACCAGAACC
AACCAACACTCCAAAATCGCAGCAGAGTGC|AGCAGGTGCTGCGGTGGGCAGCATGCAGCT
ACGGGCAACTCAGGGGTCTCAGGATCAACT|TTGGTCCAAGCGCCATTGAGCCGAACTAGA
GGGTCAAGAAGGACTCACAGGGCTAGATAC|AGAGAAGCTCTCTCGACCGTAACGTATGCT
GTCGGTGATTCTATACAACCGCCACAGCCT|CCTAGGGTCATGTCTGCATTAAGGTCGATA
ATACTTAGATTCTTAAATTGGAATTCTCCC|GGCTAGATACTTAGATTCTTAAATTGGCGC
CACAGGGCTAGATACTTAGATTCTTAAATT|ACCGTAACGTATGCTGAACAGACAGCATCT
GATGGTCGGCCTGCGTTCTAGCCATCCACC|CCATGAGCGCTTGCGCTGGCGTGAGCATTC
CTGCAGGGCTAGATACTTAGATTCTTAAAT|TTAGATTCTTAAATTGGCCCAACACAGTAA
GCTAGATACTTAGATTCTTCAGGGCTAGAT|CCGCTAATACCAGAACCTCAGGGCTAGATA
GGAAATTGGGCGTAGCGGCTATCTAAATAG|AGATACTTAGATTCTTAAATTGGTAAATTG
TTGCACGAGTAGGATACCATGACAGAAGTG|ACTTAGATTCTTAAATTGGATTGCTAAGGT
AAATTGGGAGGCAGGGCTAGATACTTACAG|GTGGATGGTCGGCCTGCGTTCTAGCCATCC
GCATCTAAGCGCCGCTCCGCTAATACCAGA|GATTCTTAAATTGGGATTCTTAAATTGGAT
AGATACTTAGATTCTTCAGGGCTAGATACT|CTAATACCAGAACCTCAGGGCTAGATACTT
AATTGGATCGGAAAAGAACACGGCCGTTGA|AGCAGAGTGCTAACGTCCACCCCAAGGCAG
GGGCTAGATACTTAGATTCTTAAATTGGGC|TCACGTCCAAGCTACCTTACTGTGTAGATG
GGGCTAGATACTTAGATTCTTAAATTGGCC|CTCAGGGGTCTCAGGATCAACTCTATGAAA
GCTAGATACTTAGATTCTTAAATTGGGCGA|ACGTCCAAGCTACCTTACTGTGTAGATGAG
TTAGATTCTTAAATTGGAATTCTCCCTCAA|AGATACTTAGATTCTTAAATTGGCGCGCTC
GCAGGGCTAGATACTTAGATTCTTAAATTG|AGATTCTTAAATTGGCCCAACACAGTAAAT
AGTCGCACCTCGAGTTTCCGGCAGACGAAC|GGCGCTAGAGTGGAGGTCTACTGTGTGCGT
CACCATTGCGCTGCGGCTCTCCTTGGTGTT|GCCAGGGACGATGACTAGTCACATGGGCCT
CGGTGTCTGCAGGGCTAGATACTTAGATTC|AGATACTTAGATTCTTAAATTGGCCCAACA
AGCAGGGCTAGATACTTAGATTCTTAAATT|GCCAGCGGTGTCTGCAGGGCTAGATACTTA
GGCCGTTGACAGCACCATTGCACGAGTAGG|CCAAGGCAGGGCTAGATACTTAGATTCTTA
TAGATTCTTAAATTGGAAATTGGGCGTAGC|AGATTCTCAGGGCTAGATACTTAGATTCTT
TGGGCGCCTCACGTCCAAGCTACCTTACTG|CACCATTGCGCTGCGGCTCTCCTTGGTGTT
GTCTCAGGATCAACTCTATGAAATAGCAGG|TTGAGCCGAACTAGAACTCGTGGGCGCCTC
ACCTTACTGTGTAGATGAGGGTAGCCGCCA|CTTGGTGTTCAGCATGGACTCCATTTTCTG
AAATAGCAGGGCTAGATACTTAGATTCTTA|TGGGCGCCTCACGTCCAAGCTACCTTACTG
AACGAGTCACCCGTGTCGTGGCTCAAGTTT|CGGTGATTCTATACAACCGCCACAGCCTCT
TAAATTGGTAAATTGGGAGGCAGGGCTAGA|ATGACAGAAGTGGATGGTCGGCCTGCGTTC
AGATACTTAGATTCTTAAATTGGAGTCCTG|GTCTGCAGGGCTAGATACTTAGATTCTTAA
GTCGGCCTGCGTTCTAGCCATCCACCGTGT|GAGCGCTTGCGCTGGCGTGAGCATTCACGC
GCTCACTCCAGGAGACGGGCAACTCAGGGG|TGGCTCAAGTTTCATTGGTCCAAGCGCCAT
GTATAGGATGCTCAAAGTCTCCAGGAAGCC|CTAGATACTTAGATTCTTAAATTGGAATTC
GGGAGGCAGGGCTAGATACTTACAGGGCTA|TGGTCGGCCTGCGTTCTAGCCATCCACCGT
TTCTTAAATTGGTGGAGTATAGGATGCTCA|GACACACACATCAGGGCTAGATACTTAGAT
GCTCAAGTTTCATTGGTCCAAGCGCCATTG|CACAGCCTCTGAGTCGCACCTCGAGTTTCC
GGGCAGCATGCAGCTTACGCAGAACTGAAG|CCCCCAACGTGACAAGGGGTCCTTACCAGC
ACGCCGACACACACATCAGGGCTAGATACT|TAATTTCGGGATTATAGCCAACCAGGGCTA
CGCTAATACCAGAACCTCAGGGCTAGATAC|TCTTAAATTGGATCGGAAAAGAACACGGCC
GAAGTGGATGGTCGGCCTGCGTTCTAGCCA|TAAGGTCCATGAGCGCTTGCGCTGGCGTGA
ATTCTATACAACCGCCACAGCCTCTGAGTC|TCATGTCTGCATTAAGGTCGATAGTAGGCG
ACTTAGATTCTTAAATTGGCCCAACACAGT|CTCAGGATCAACTCTATGAAATAGCAGGGC
TAGGGCTCCATCGCTCAGGGCTAGATACTT|CTCCAGGAGACGGGCAACTCAGGGGTCTCA
CGCGCTCACTCCAGGAGACGGGCAACTCAG|TCGTGGCTCAAGTTTCATTGGTCCAAGCGC
GAAGCCCCCAACGTGACAAGGGGTCCTTAC|GAATTCTCCCTCAACTAGGGCTCCATCGCT
GGACTCACAGGGCTAGATACTTAGATTCTT|TCTCGACCGTAACGTATGCTGAACAGACAG
TGAACAGACAGCATCTAAGCGCCGCTCCGC|TAGATACTTAGATTCTTAAATTGGGATTCT
CACACATCAGGGCTAGATACTTAGATTCTT|GATTATAGCCAACCAGGGCTAGATACTTAG
GGCTAGATACTTAGATTCTTAAATTGGCGC|GGACCAGCGAATAACGAGTCACCCGTGTCG
GGGTCCTTACCAGCCAGCGGTGTCTGCAGG|CTCCATCGCTCAGGGCTAGATACTTAGATT
CTCTGAGTCGCACCTCGAGTTTCCGGCAGA|TAGTAGGCGCTAGAGTGGAGGTCTACTGTG
GCGCCGCTCCGCTAATACCAGAACCTCAGG|AATTGGGATTCTTAAATTGGATCGGAAAAG
ATTTCGGGATTATAGCCAACCAGGGCTAGA|TAAATTGGGCGATAAGTAACAGAGGACCAG
ATATCACCATTGCGCTGCGGCTCTCCTTGG|CTCCGCCAGGGACGATGACTAGTCACATGG
GAGGGTAGCCGCCATCGACCGATCGTCGGT|GACTCCATTTTCTGGTTGAAGTCCCCTAGG
GGGCTAGATACTTAGATTCTTAAATTGGAG|GCGGTGTCTGCAGGGCTAGATACTTAGATT
CCTGCGTTCTAGCCATCCACCGTGTCTAAG|CTTGCGCTGGCGTGAGCATTCACGCCTCGG
AGATGAGGGTAGCCGCCATCGACCGATCGT|CATGGACTCCATTTTCTGGTTGAAGTCCCC
CAGAAGTGGATGGTCGGCCTGCGTTCTAGC|GCTAAGGTCCATGAGCGCTTGCGCTGGCGT
TTAAATTGGCCCAACACAGTAAATGAGCTA|ACTCTATGAAATAGCAGGGCTAGATACTTA
TGCGCTGCGGCTCTCCTTGGTGTTCAGCAT|GACGATGACTAGTCACATGGGCCTTTCGGC
TGATTCTATACAACCGCCACAGCCTCTGAG|GGTCATGTCTGCATTAAGGTCGATAGTAGG
AAGTTTCATTGGTCCAAGCGCCATTGAGCC|GCCTCTGAGTCGCACCTCGAGTTTCCGGCA
AATTGGCCCAACACAGTAAATGAGCTAAAC|CTATGAAATAGCAGGGCTAGATACTTAGAT
CTCACTCCAGGAGACGGGCAACTCAGGGGT|GGCTCAAGTTTCATTGGTCCAAGCGCCATT
CGTCCAAGCTACCTTACTGTGTAGATGAGG|TGCGGCTCTCCTTGGTGTTCAGCATGGACT
GCCCAACACAGTAAATGAGCTAAACATAAT|AAATAGCAGGGCTAGATACTTAGATTCTTA
CCAGAACCTCAGGGCTAGATACTTAGATTC|TGGATCGGAAAAGAACACGGCCGTTGACAG
GAACCAACACTCCAAAATCGCAGCAGAGTG|TAGCAGGTGCTGCGGTGGGCAGCATGCAGC
CAGAGTGCTAACGTCCACCCCAAGGCAGGG|ATGCAGCTTACGCAGAACTGAAGCAGGGCT
AACACTCCAAAATCGCAGCAGAGTGCTAAC|GGTGCTGCGGTGGGCAGCATGCAGCTTACG
ATTGGATCGGAAAAGAACACGGCCGTTGAC|GCAGAGTGCTAACGTCCACCCCAAGGCAGG
GGCTAGATACTTAGATTCTTAAATTGGCCC|TCAGGGGTCTCAGGATCAACTCTATGAAAT
TCGCACCTCGAGTTTCCGGCAGACGAACCT|CGCTAGAGTGGAGGTCTACTGTGTGCGTAT
TTGGGCGATAAGTAACAGAGGACCAGCGAA|TAGATGAGGGTAGCCGCCATCGACCGATCG
CTCAAGTTTCATTGGTCCAAGCGCCATTGA|ACAGCCTCTGAGTCGCACCTCGAGTTTCCG
ATTGGAAATTGGGCGTAGCGGCTATCTAAA|GCTAGATACTTAGATTCTTAAATTGGTAAA
GCGCTTGCGCTGGCGTGAGCATTCACGCCT|ACTTAGATTCTTAAATTGGTGGAGTATAGG
ACCGTAACGTATGCTGAACAGACAGCATCT|GATACTTACAGGGCTAGATACTTAGATTCT
CTTACTGTGTAGATGAGGGTAGCCGCCATC|TGGTGTTCAGCATGGACTCCATTTTCTGGT
TCGTGGCTCAAGTTTCATTGGTCCAAGCGC|ACCGCCACAGCCTCTGAGTCGCACCTCGAG
AGATACTTAGATTCTTAAATTGGTAGACAG|TATGCTGAACAGACAGCATCTAAGCGCCGC
CTAGCCATCCACCGTGTCTAAGTGGAACCA|GGCGTGAGCATTCACGCCTCGGAGTAGCAG
CTCGTGGGCGCCTCACGTCCAAGCTACCTT|ATATCACCATTGCGCTGCGGCTCTCCTTGG
CAGGGCTAGATACTTAGATTCTTAAATTGG|GATTCTTAAATTGGCCCAACACAGTAAATG
GGTCCTTACCAGCCAGCGGTGTCTGCAGGG|TCCATCGCTCAGGGCTAGATACTTAGATTC
TAGCCATCCACCGTGTCTAAGTGGAACCAA|GCGTGAGCATTCACGCCTCGGAGTAGCAGG
GAGTGCTAACGTCCACCCCAAGGCAGGGCT|GCAGCTTACGCAGAACTGAAGCAGGGCTAG
ATTGGCGTTTTACGACGCCGACACACACAT|AAATGAGCTAAACATAATTTCGGGATTATA
GATTCTTAAATTGGCCCAACACAGTAAATG|GATCAACTCTATGAAATAGCAGGGCTAGAT
AAGCTACCTTACTGTGTAGATGAGGGTAGC|CTCTCCTTGGTGTTCAGCATGGACTCCATT
GGATTGCTAAGGTCCATGAGCGCTTGCGCT|AGTCCTGTCAGGGCTAGATACTTAGATTCT
CTTAGATTCTTAAATTGGGATTCTTAAATT|AAGTGGAACCAACACTCCAAAATCGCAGCA
CCATGAGCGCTTGCGCTGGCGTGAGCATTC|CTAGATACTTAGATTCTTAAATTGGTGGAG
TCATTGGTCCAAGCGCCATTGAGCCGAACT|TGAGTCGCACCTCGAGTTTCCGGCAGACGA
GATTCTTCAGGGCTAGATACTTAGATTCTT|GAACCTCAGGGCTAGATACTTAGATTCTCA
TCTTAAATTGGGCGATAAGTAACAGAGGAC|TACTGTGTAGATGAGGGTAGCCGCCATCGA
GAACCTATATCACCATTGCGCTGCGGCTCT|GCGTATCTCCGCCAGGGACGATGACTAGTC
GCAGAACTGAAGCAGGGCTAGATACTTAGA|GTCCTTACCAGCCAGCGGTGTCTGCAGGGC
ATACCATGACAGAAGTGGATGGTCGGCCTG|AATTGGATTGCTAAGGTCCATGAGCGCTTG
AGCGGCTATCTAAATAGAGAAGCTCTCTCG|CTTAAATTGGTAAATTGGGAGGCAGGGCTA
TAAATTGGAATTCTCCCTCAACTAGGGCTC|GATTCTTAAATTGGCGCGCTCACTCCAGGA
CTAAGGTCCATGAGCGCTTGCGCTGGCGTG|GTCAGGGCTAGATACTTAGATTCTTAAATT
CCAACCAGGGCTAGATACTTAGATTCTTAA|GTAACAGAGGACCAGCGAATAACGAGTCAC
CTTAAATTGGTAAATTGGGAGGCAGGGCTA|CCATGACAGAAGTGGATGGTCGGCCTGCGT
GCGCGCTCACTCCAGGAGACGGGCAACTCA|GTCGTGGCTCAAGTTTCATTGGTCCAAGCG
AGGACCAGCGAATAACGAGTCACCCGTGTC|ATCGACCGATCGTCGGTGATTCTATACAAC
ATAGGATGCTCAAAGTCTCCAGGAAGCCCC|AGATACTTAGATTCTTAAATTGGAATTCTC
ACTAGAACTCGTGGGCGCCTCACGTCCAAG|CGAACCTATATCACCATTGCGCTGCGGCTC
GATACTTAGATTCTTAAATTGGTAGACAGG|ATGCTGAACAGACAGCATCTAAGCGCCGCT
TAGCCGCCATCGACCGATCGTCGGTGATTC|CATTTTCTGGTTGAAGTCCCCTAGGGTCAT
TCTTAAATTGGTGGAGTATAGGATGCTCAA|ACACACACATCAGGGCTAGATACTTAGATT
TGCTGCGGTGGGCAGCATGCAGCTTACGCA|TCCAGGAAGCCCCCAACGTGACAAGGGGTC
CTCCGCTAATACCAGAACCTCAGGGCTAGA|GATTCTTAAATTGGATCGGAAAAGAACACG
AGGGCTCCATCGCTCAGGGCTAGATACTTA|TCCAGGAGACGGGCAACTCAGGGGTCTCAG
GATTATAGCCAACCAGGGCTAGATACTTAG|GGCGATAAGTAACAGAGGACCAGCGAATAA
GGCGCGCTCACTCCAGGAGACGGGCAACTC|TGTCGTGGCTCAAGTTTCATTGGTCCAAGC
TTCTTAAATTGGCGTTTTACGACGCCGACA|ACACAGTAAATGAGCTAAACATAATTTCGG
TATAGGATGCTCAAAGTCTCCAGGAAGCCC|TAGATACTTAGATTCTTAAATTGGAATTCT
ACCAGAACCTCAGGGCTAGATACTTAGATT|TTGGATCGGAAAAGAACACGGCCGTTGACA
TGGCTCAAGTTTCATTGGTCCAAGCGCCAT|GCCACAGCCTCTGAGTCGCACCTCGAGTTT
TGGATGGTCGGCCTGCGTTCTAGCCATCCA|GTCCATGAGCGCTTGCGCTGGCGTGAGCAT
TCTCGACCGTAACGTATGCTGAACAGACAG|GGCTAGATACTTACAGGGCTAGATACTTAG
ATAAGTAACAGAGGACCAGCGAATAACGAG|GGGTAGCCGCCATCGACCGATCGTCGGTGA
GCCACAGCCTCTGAGTCGCACCTCGAGTTT|AAGGTCGATAGTAGGCGCTAGAGTGGAGGT
GCTAATACCAGAACCTCAGGGCTAGATACT|CTTAAATTGGATCGGAAAAGAACACGGCCG
TAGATACTTAGATTCTTAAATTGGCCCAAC|GGGGTCTCAGGATCAACTCTATGAAATAGC
GCGGTGTCTGCAGGGCTAGATACTTAGATT|TAGATACTTAGATTCTTAAATTGGCCCAAC
TTCTTAAATTGGAATTCTCCCTCAACTAGG|CTTAGATTCTTAAATTGGCGCGCTCACTCC
CCTATATCACCATTGCGCTGCGGCTCTCCT|TATCTCCGCCAGGGACGATGACTAGTCACA
GGGCGCCTCACGTCCAAGCTACCTTACTGT|ACCATTGCGCTGCGGCTCTCCTTGGTGTTC
CCAGCCAGCGGTGTCTGCAGGGCTAGATAC|TCAGGGCTAGATACTTAGATTCTTAAATTG
GATTCTTAAATTGGAATTCTCCCTCAACTA|TACTTAGATTCTTAAATTGGCGCGCTCACT
AAATTGGTAGACAGGGCTAGATACTTAGAT|CATCTAAGCGCCGCTCCGCTAATACCAGAA
GGCTAGATACTTAGATTCTTAAATTGGATT|CTAGATACTTAGATTCTTAAATTGGAGTCC
GGATCGGAAAAGAACACGGCCGTTGACAGC|GAGTGCTAACGTCCACCCCAAGGCAGGGCT
ACCATTGCGCTGCGGCTCTCCTTGGTGTTC|CCAGGGACGATGACTAGTCACATGGGCCTT
GATACTTAGATTCTTAAATTGGCGCGCTCA|AGCGAATAACGAGTCACCCGTGTCGTGGCT
ACTCACAGGGCTAGATACTTAGATTCTTAA|TCGACCGTAACGTATGCTGAACAGACAGCA
ATACTTAGATTCTTAAATTGGGCGATAAGT|CAAGCTACCTTACTGTGTAGATGAGGGTAG
GGGCTAGATACTTAGATTCTTCAGGGCTAG|CTCCGCTAATACCAGAACCTCAGGGCTAGA
GCATGCAGCTTACGCAGAACTGAAGCAGGG|AACGTGACAAGGGGTCCTTACCAGCCAGCG
CAAAGTCTCCAGGAAGCCCCCAACGTGACA|ATTCTTAAATTGGAATTCTCCCTCAACTAG
TACTTAGATTCTTAAATTGGCGCGCTCACT|CGAATAACGAGTCACCCGTGTCGTGGCTCA
AGAAGGACTCACAGGGCTAGATACTTAGAT|GCTCTCTCGACCGTAACGTATGCTGAACAG
GCAACTCAGGGGTCTCAGGATCAACTCTAT|TCCAAGCGCCATTGAGCCGAACTAGAACTC
TAAATTGGAGTCCTGTCAGGGCTAGATACT|TACTTAGATTCTTAAATTGGCGTTTTACGA
TAAATAGAGAAGCTCTCTCGACCGTAACGT|TAAATTGGGAGGCAGGGCTAGATACTTACA
CGCAGAACTGAAGCAGGGCTAGATACTTAG|GGTCCTTACCAGCCAGCGGTGTCTGCAGGG
TCAGGATCAACTCTATGAAATAGCAGGGCT|AGCCGAACTAGAACTCGTGGGCGCCTCACG
ATGAGGGTAGCCGCCATCGACCGATCGTCG|TGGACTCCATTTTCTGGTTGAAGTCCCCTA
ATTGGAGTCCTGTCAGGGCTAGATACTTAG|TTAGATTCTTAAATTGGCGTTTTACGACGC
CGATCGTCGGTGATTCTATACAACCGCCAC|AGTCCCCTAGGGTCATGTCTGCATTAAGGT
CTGCGGTGGGCAGCATGCAGCTTACGCAGA|CAGGAAGCCCCCAACGTGACAAGGGGTCCT
GCTAGATACTTAGATTCTTAAATTGGCGCG|GACCAGCGAATAACGAGTCACCCGTGTCGT
CACAGTAAATGAGCTAAACATAATTTCGGG|CAGGGCTAGATACTTAGATTCTTAAATTGG
AGCCGCCATCGACCGATCGTCGGTGATTCT|ATTTTCTGGTTGAAGTCCCCTAGGGTCATG
AGGACTCACAGGGCTAGATACTTAGATTCT|CTCTCGACCGTAACGTATGCTGAACAGACA
CGCTCAGGGCTAGATACTTAGATTCTTAAA|GGGCAACTCAGGGGTCTCAGGATCAACTCT
TGGGAGGCAGGGCTAGATACTTACAGGGCT|ATGGTCGGCCTGCGTTCTAGCCATCCACCG
TAGATTCTTAAATTGGTGGAGTATAGGATG|CGCCGACACACACATCAGGGCTAGATACTT
TGACAGAAGTGGATGGTCGGCCTGCGTTCT|ATTGCTAAGGTCCATGAGCGCTTGCGCTGG
GGTGCTGCGGTGGGCAGCATGCAGCTTACG|TCTCCAGGAAGCCCCCAACGTGACAAGGGG
GAGCTAAACATAATTTCGGGATTATAGCCA|TACTTAGATTCTTAAATTGGGCGATAAGTA
TCCAGGAGACGGGCAACTCAGGGGTCTCAG|AAGTTTCATTGGTCCAAGCGCCATTGAGCC
CAGGGCTAGATACTTAGATTCTTAAATTGG|CAGCGGTGTCTGCAGGGCTAGATACTTAGA
ATGACAGAAGTGGATGGTCGGCCTGCGTTC|GATTGCTAAGGTCCATGAGCGCTTGCGCTG
CCTTACTGTGTAGATGAGGGTAGCCGCCAT|TTGGTGTTCAGCATGGACTCCATTTTCTGG
CAGGTGCTGCGGTGGGCAGCATGCAGCTTA|AGTCTCCAGGAAGCCCCCAACGTGACAAGG
CTAAATAGAGAAGCTCTCTCGACCGTAACG|GTAAATTGGGAGGCAGGGCTAGATACTTAC
GATTCTTAAATTGGGCGATAAGTAACAGAG|CCTTACTGTGTAGATGAGGGTAGCCGCCAT
ACGCAGAACTGAAGCAGGGCTAGATACTTA|GGGTCCTTACCAGCCAGCGGTGTCTGCAGG
CCAGGGCTAGATACTTAGATTCTTAAATTG|CAGAGGACCAGCGAATAACGAGTCACCCGT
CTAATACCAGAACCTCAGGGCTAGATACTT|TTAAATTGGATCGGAAAAGAACACGGCCGT
GGTGGGCAGCATGCAGCTTACGCAGAACTG|AAGCCCCCAACGTGACAAGGGGTCCTTACC
GCAGGGCTAGATACTTAGATTCTTAAATTG|CCAGCGGTGTCTGCAGGGCTAGATACTTAG
CGTGAGCATTCACGCCTCGGAGTAGCAGGT|AATTGGTGGAGTATAGGATGCTCAAAGTCT
CGGAAAAGAACACGGCCGTTGACAGCACCA|GCTAACGTCCACCCCAAGGCAGGGCTAGAT
GCCATCGACCGATCGTCGGTGATTCTATAC|TCTGGTTGAAGTCCCCTAGGGTCATGTCTG
CCATTGCGCTGCGGCTCTCCTTGGTGTTCA|CAGGGACGATGACTAGTCACATGGGCCTTT
TCTTCAGGGCTAGATACTTAGATTCTTAAA|CCTCAGGGCTAGATACTTAGATTCTCAGGG
ATTGCACGAGTAGGATACCATGACAGAAGT|TACTTAGATTCTTAAATTGGATTGCTAAGG
TCTTAAATTGGAATTCTCCCTCAACTAGGG|TTAGATTCTTAAATTGGCGCGCTCACTCCA
AGTTTCATTGGTCCAAGCGCCATTGAGCCG|CCTCTGAGTCGCACCTCGAGTTTCCGGCAG
CAAAATCGCAGCAGAGTGCTAACGTCCACC|CGGTGGGCAGCATGCAGCTTACGCAGAACT
CGCCGCTCCGCTAATACCAGAACCTCAGGG|ATTGGGATTCTTAAATTGGATCGGAAAAGA
ACCATGACAGAAGTGGATGGTCGGCCTGCG|TTGGATTGCTAAGGTCCATGAGCGCTTGCG
TGCTAAGGTCCATGAGCGCTTGCGCTGGCG|CTGTCAGGGCTAGATACTTAGATTCTTAAA
TAAATTGGATTGCTAAGGTCCATGAGCGCT|AATTGGAGTCCTGTCAGGGCTAGATACTTA
TTCTTAAATTGGAAATTGGGCGTAGCGGCT|TCTCAGGGCTAGATACTTAGATTCTTAAAT
TCCACCCCAAGGCAGGGCTAGATACTTAGA|AGAACTGAAGCAGGGCTAGATACTTAGATT
CAACCAGGGCTAGATACTTAGATTCTTAAA|TAACAGAGGACCAGCGAATAACGAGTCACC
GATACTTAGATTCTTAAATTGGTGGAGTAT|TTACGACGCCGACACACACATCAGGGCTAG
CAAGGCAGGGCTAGATACTTAGATTCTTAA|AAGCAGGGCTAGATACTTAGATTCTTAAAT
TACCATGACAGAAGTGGATGGTCGGCCTGC|ATTGGATTGCTAAGGTCCATGAGCGCTTGC
GTCCAAGCTACCTTACTGTGTAGATGAGGG|GCGGCTCTCCTTGGTGTTCAGCATGGACTC
CAACTCTATGAAATAGCAGGGCTAGATACT|CTAGAACTCGTGGGCGCCTCACGTCCAAGC
GACAAGGGGTCCTTACCAGCCAGCGGTGTC|CTAGGGCTCCATCGCTCAGGGCTAGATACT
AGATTCTTAAATTGGTAGACAGGGCTAGAT|ACAGACAGCATCTAAGCGCCGCTCCGCTAA
CTCAGGGGTCTCAGGATCAACTCTATGAAA|AGCGCCATTGAGCCGAACTAGAACTCGTGG
TTAGATTCTTAAATTGGAAATTGGGCGTAG|TAGATTCTCAGGGCTAGATACTTAGATTCT
TTAAATTGGTAAATTGGGAGGCAGGGCTAG|CATGACAGAAGTGGATGGTCGGCCTGCGTT
CTAGATACTTACAGGGCTAGATACTTAGAT|CGTTCTAGCCATCCACCGTGTCTAAGTGGA
CAAGCGCCATTGAGCCGAACTAGAACTCGT|CCTCGAGTTTCCGGCAGACGAACCTATATC
TCAGGGCTAGATACTTAGATTCTTAAATTG|CAACTCAGGGGTCTCAGGATCAACTCTATG
TCTTAAATTGGAGTCCTGTCAGGGCTAGAT|AGATACTTAGATTCTTAAATTGGCGTTTTA
AGGGCTAGATACTTAGATTCTCAGGGCTAG|AAGAACACGGCCGTTGACAGCACCATTGCA
CTAGATACTTAGATTCTTAAATTGGTAGAC|CGTATGCTGAACAGACAGCATCTAAGCGCC
GACAGGGCTAGATACTTAGATTCTTCAGGG|GCCGCTCCGCTAATACCAGAACCTCAGGGC
AGCGGTGTCTGCAGGGCTAGATACTTAGAT|CTAGATACTTAGATTCTTAAATTGGCCCAA
TCCACCGTGTCTAAGTGGAACCAACACTCC|GCATTCACGCCTCGGAGTAGCAGGTGCTGC
GTAGCCGCCATCGACCGATCGTCGGTGATT|CCATTTTCTGGTTGAAGTCCCCTAGGGTCA
TCTAAGCGCCGCTCCGCTAATACCAGAACC|TCTTAAATTGGGATTCTTAAATTGGATCGG
GGATACCATGACAGAAGTGGATGGTCGGCC|TAAATTGGATTGCTAAGGTCCATGAGCGCT
AGCATGCAGCTTACGCAGAACTGAAGCAGG|CAACGTGACAAGGGGTCCTTACCAGCCAGC
ATGAAATAGCAGGGCTAGATACTTAGATTC|TCGTGGGCGCCTCACGTCCAAGCTACCTTA
CTTAAATTGGCGTTTTACGACGCCGACACA|ACAGTAAATGAGCTAAACATAATTTCGGGA
CGCTTGCGCTGGCGTGAGCATTCACGCCTC|CTTAGATTCTTAAATTGGTGGAGTATAGGA
CAGGGCTAGATACTTAGATTCTTAAATTGG|AGGGCTAGATACTTAGATTCTCAGGGCTAG
AGAACCTCAGGGCTAGATACTTAGATTCTC|GATCGGAAAAGAACACGGCCGTTGACAGCA
AATTGGATTGCTAAGGTCCATGAGCGCTTG|TTGGAGTCCTGTCAGGGCTAGATACTTAGA
ACTAGGGCTCCATCGCTCAGGGCTAGATAC|CACTCCAGGAGACGGGCAACTCAGGGGTCT
ATTCTCCCTCAACTAGGGCTCCATCGCTCA|ATTGGCGCGCTCACTCCAGGAGACGGGCAA
ACCTATATCACCATTGCGCTGCGGCTCTCC|GTATCTCCGCCAGGGACGATGACTAGTCAC
AACACGGCCGTTGACAGCACCATTGCACGA|CCACCCCAAGGCAGGGCTAGATACTTAGAT
GAAGGACTCACAGGGCTAGATACTTAGATT|CTCTCTCGACCGTAACGTATGCTGAACAGA
GATACTTAGATTCTTAAATTGGAAATTGGG|ATACTTAGATTCTCAGGGCTAGATACTTAG
AGTTTCCGGCAGACGAACCTATATCACCAT|GAGGTCTACTGTGTGCGTATCTCCGCCAGG
CGTGTCGTGGCTCAAGTTTCATTGGTCCAA|TACAACCGCCACAGCCTCTGAGTCGCACCT
TTGGGCGTAGCGGCTATCTAAATAGAGAAG|CTTAGATTCTTAAATTGGTAAATTGGGAGG
CCAAAATCGCAGCAGAGTGCTAACGTCCAC|GCGGTGGGCAGCATGCAGCTTACGCAGAAC
CCTCGAGTTTCCGGCAGACGAACCTATATC|GAGTGGAGGTCTACTGTGTGCGTATCTCCG
AGAAGTGGATGGTCGGCCTGCGTTCTAGCC|CTAAGGTCCATGAGCGCTTGCGCTGGCGTG
CAGCAGAGTGCTAACGTCCACCCCAAGGCA|AGCATGCAGCTTACGCAGAACTGAAGCAGG
AAATTGGATTGCTAAGGTCCATGAGCGCTT|ATTGGAGTCCTGTCAGGGCTAGATACTTAG
TCGGAGTAGCAGGTGCTGCGGTGGGCAGCA|GATGCTCAAAGTCTCCAGGAAGCCCCCAAC
GAGTTTCCGGCAGACGAACCTATATCACCA|GGAGGTCTACTGTGTGCGTATCTCCGCCAG
GGCTCAAGTTTCATTGGTCCAAGCGCCATT|CCACAGCCTCTGAGTCGCACCTCGAGTTTC
GTCACCCGTGTCGTGGCTCAAGTTTCATTG|ATTCTATACAACCGCCACAGCCTCTGAGTC
TACAGGGCTAGATACTTAGATTCTTAAATT|CATCCACCGTGTCTAAGTGGAACCAACACT
TAGCCAACCAGGGCTAGATACTTAGATTCT|TAAGTAACAGAGGACCAGCGAATAACGAGT
CTCACGTCCAAGCTACCTTACTGTGTAGAT|GCGCTGCGGCTCTCCTTGGTGTTCAGCATG
TGACAGCACCATTGCACGAGTAGGATACCA|CAGGGCTAGATACTTAGATTCTTAAATTGG
CCTCAGGGCTAGATACTTAGATTCTCAGGG|GGAAAAGAACACGGCCGTTGACAGCACCAT
CTTAGATTCTTCAGGGCTAGATACTTAGAT|ACCAGAACCTCAGGGCTAGATACTTAGATT
CCAAGCTACCTTACTGTGTAGATGAGGGTA|GGCTCTCCTTGGTGTTCAGCATGGACTCCA
TTCTATACAACCGCCACAGCCTCTGAGTCG|CATGTCTGCATTAAGGTCGATAGTAGGCGC
TCAGGGCTAGATACTTAGATTCTTAAATTG|ATTGGCGTTTTACGACGCCGACACACACAT
AATTGGAAATTGGGCGTAGCGGCTATCTAA|GGCTAGATACTTAGATTCTTAAATTGGTAA
CACATCAGGGCTAGATACTTAGATTCTTAA|TTATAGCCAACCAGGGCTAGATACTTAGAT
GGCGATAAGTAACAGAGGACCAGCGAATAA|ATGAGGGTAGCCGCCATCGACCGATCGTCG
TACTTAGATTCTTAAATTGGGATTCTTAAA|CTAAGTGGAACCAACACTCCAAAATCGCAG
AGAACTGAAGCAGGGCTAGATACTTAGATT|CCTTACCAGCCAGCGGTGTCTGCAGGGCTA
TCCAAGCTACCTTACTGTGTAGATGAGGGT|CGGCTCTCCTTGGTGTTCAGCATGGACTCC
GCGTTCTAGCCATCCACCGTGTCTAAGTGG|GCGCTGGCGTGAGCATTCACGCCTCGGAGT
GCTCAGGGCTAGATACTTAGATTCTTAAAT|GGCAACTCAGGGGTCTCAGGATCAACTCTA
TTAGATTCTTAAATTGGTGGAGTATAGGAT|ACGCCGACACACACATCAGGGCTAGATACT
TTGGAGTCCTGTCAGGGCTAGATACTTAGA|TAGATTCTTAAATTGGCGTTTTACGACGCC
CTCAGGGCTAGATACTTAGATTCTCAGGGC|GAAAAGAACACGGCCGTTGACAGCACCATT
CGCACCTCGAGTTTCCGGCAGACGAACCTA|GCTAGAGTGGAGGTCTACTGTGTGCGTATC
CCCGTGTCGTGGCTCAAGTTTCATTGGTCC|TATACAACCGCCACAGCCTCTGAGTCGCAC
AGATTCTTAAATTGGAGTCCTGTCAGGGCT|GGCTAGATACTTAGATTCTTAAATTGGCGT
GATTCTTAAATTGGATCGGAAAAGAACACG|AAAATCGCAGCAGAGTGCTAACGTCCACCC
AGAGGACCAGCGAATAACGAGTCACCCGTG|CCATCGACCGATCGTCGGTGATTCTATACA
ATACTTAGATTCTTAAATTGGCGTTTTACG|ATTGGCCCAACACAGTAAATGAGCTAAACA
ACTTAGATTCTTAAATTGGGCGATAAGTAA|AGCTACCTTACTGTGTAGATGAGGGTAGCC
GAGTATAGGATGCTCAAAGTCTCCAGGAAG|GGCTAGATACTTAGATTCTTAAATTGGAAT
GTTTCATTGGTCCAAGCGCCATTGAGCCGA|CTCTGAGTCGCACCTCGAGTTTCCGGCAGA
TTGACAGCACCATTGCACGAGTAGGATACC|GCAGGGCTAGATACTTAGATTCTTAAATTG
TAAATTGGCGCGCTCACTCCAGGAGACGGG|CACCCGTGTCGTGGCTCAAGTTTCATTGGT
TCTTAAATTGGATTGCTAAGGTCCATGAGC|TTAAATTGGAGTCCTGTCAGGGCTAGATAC
TTCTTAAATTGGTAGACAGGGCTAGATACT|GACAGCATCTAAGCGCCGCTCCGCTAATAC
TCAGGGCTAGATACTTAGATTCTTAAATTG|CAGGGCTAGATACTTAGATTCTCAGGGCTA
GAGTAGCAGGTGCTGCGGTGGGCAGCATGC|GCTCAAAGTCTCCAGGAAGCCCCCAACGTG
CCGTAACGTATGCTGAACAGACAGCATCTA|ATACTTACAGGGCTAGATACTTAGATTCTT
GTCAGGGCTAGATACTTAGATTCTTAAATT|AATTGGCGTTTTACGACGCCGACACACACA
ATGAGCTAAACATAATTTCGGGATTATAGC|GATACTTAGATTCTTAAATTGGGCGATAAG
CACGTCCAAGCTACCTTACTGTGTAGATGA|GCTGCGGCTCTCCTTGGTGTTCAGCATGGA
GGCTAGATACTTAGATTCTTAAATTGGAAT|AACCAGGGCTAGATACTTAGATTCTTAAAT
GGGCTAGATACTTAGATTCTTAAATTGGCG|TTCTTAAATTGGCCCAACACAGTAAATGAG
CCATTGCACGAGTAGGATACCATGACAGAA|GATACTTAGATTCTTAAATTGGATTGCTAA
GACAGAAGTGGATGGTCGGCCTGCGTTCTA|TTGCTAAGGTCCATGAGCGCTTGCGCTGGC
GGGGTCAAGAAGGACTCACAGGGCTAGATA|TAGAGAAGCTCTCTCGACCGTAACGTATGC
GTGGAGTATAGGATGCTCAAAGTCTCCAGG|CAGGGCTAGATACTTAGATTCTTAAATTGG
CGTATGCTGAACAGACAGCATCTAAGCGCC|ACAGGGCTAGATACTTAGATTCTTAAATTG
TCACCATTGCGCTGCGGCTCTCCTTGGTGT|CGCCAGGGACGATGACTAGTCACATGGGCC
GCGTTTTACGACGCCGACACACACATCAGG|GAGCTAAACATAATTTCGGGATTATAGCCA
GGCTATCTAAATAGAGAAGCTCTCTCGACC|AAATTGGTAAATTGGGAGGCAGGGCTAGAT
TAGATACTTAGATTCTTAAATTGGGATTCT|GTGTCTAAGTGGAACCAACACTCCAAAATC
CAGCACCATTGCACGAGTAGGATACCATGA|GGCTAGATACTTAGATTCTTAAATTGGATT
TCTTAAATTGGATCGGAAAAGAACACGGCC|ATCGCAGCAGAGTGCTAACGTCCACCCCAA
GCACGAGTAGGATACCATGACAGAAGTGGA|TTAGATTCTTAAATTGGATTGCTAAGGTCC
CAAGTTTCATTGGTCCAAGCGCCATTGAGC|AGCCTCTGAGTCGCACCTCGAGTTTCCGGC
ATAGCCAACCAGGGCTAGATACTTAGATTC|ATAAGTAACAGAGGACCAGCGAATAACGAG
TGGAGTATAGGATGCTCAAAGTCTCCAGGA|AGGGCTAGATACTTAGATTCTTAAATTGGA
AGCTCTCTCGACCGTAACGTATGCTGAACA|GGCAGGGCTAGATACTTACAGGGCTAGATA
ACAGCATCTAAGCGCCGCTCCGCTAATACC|TTAGATTCTTAAATTGGGATTCTTAAATTG
CACTCCAAAATCGCAGCAGAGTGCTAACGT|TGCTGCGGTGGGCAGCATGCAGCTTACGCA
ACACACACATCAGGGCTAGATACTTAGATT|CGGGATTATAGCCAACCAGGGCTAGATACT
CAACCGCCACAGCCTCTGAGTCGCACCTCG|GCATTAAGGTCGATAGTAGGCGCTAGAGTG
CGTCGGTGATTCTATACAACCGCCACAGCC|CCCTAGGGTCATGTCTGCATTAAGGTCGAT
CCATGACAGAAGTGGATGGTCGGCCTGCGT|TGGATTGCTAAGGTCCATGAGCGCTTGCGC
ACTTAGATTCTTAAATTGGAGTCCTGTCAG|GCAGGGCTAGATACTTAGATTCTTAAATTG
TAAATTGGGAGGCAGGGCTAGATACTTACA|AGTGGATGGTCGGCCTGCGTTCTAGCCATC
GCTAAGGTCCATGAGCGCTTGCGCTGGCGT|TGTCAGGGCTAGATACTTAGATTCTTAAAT
GGAGTAGCAGGTGCTGCGGTGGGCAGCATG|TGCTCAAAGTCTCCAGGAAGCCCCCAACGT
TCACGCCTCGGAGTAGCAGGTGCTGCGGTG|AGTATAGGATGCTCAAAGTCTCCAGGAAGC
TCTTAAATTGGGATTCTTAAATTGGATCGG|ACCAACACTCCAAAATCGCAGCAGAGTGCT
CCCCAAGGCAGGGCTAGATACTTAGATTCT|CTGAAGCAGGGCTAGATACTTAGATTCTTA
TTGGCGCGCTCACTCCAGGAGACGGGCAAC|CGTGTCGTGGCTCAAGTTTCATTGGTCCAA
TACCAGAACCTCAGGGCTAGATACTTAGAT|ATTGGATCGGAAAAGAACACGGCCGTTGAC
AAGGGGTCCTTACCAGCCAGCGGTGTCTGC|GGGCTCCATCGCTCAGGGCTAGATACTTAG
GTGGCTCAAGTTTCATTGGTCCAAGCGCCA|CGCCACAGCCTCTGAGTCGCACCTCGAGTT
ATTCTTCAGGGCTAGATACTTAGATTCTTA|AACCTCAGGGCTAGATACTTAGATTCTCAG
TTCTTAAATTGGCGCGCTCACTCCAGGAGA|GAGTCACCCGTGTCGTGGCTCAAGTTTCAT
TTAGATTCTTAAATTGGCGTTTTACGACGC|GCCCAACACAGTAAATGAGCTAAACATAAT
GTCTAAGTGGAACCAACACTCCAAAATCGC|GCCTCGGAGTAGCAGGTGCTGCGGTGGGCA
GTAGATGAGGGTAGCCGCCATCGACCGATC|AGCATGGACTCCATTTTCTGGTTGAAGTCC
TTAAATTGGCGTTTTACGACGCCGACACAC|CAGTAAATGAGCTAAACATAATTTCGGGAT
CGCTCACTCCAGGAGACGGGCAACTCAGGG|GTGGCTCAAGTTTCATTGGTCCAAGCGCCA
CATCGACCGATCGTCGGTGATTCTATACAA|TGGTTGAAGTCCCCTAGGGTCATGTCTGCA
AATTGGAGTCCTGTCAGGGCTAGATACTTA|CTTAGATTCTTAAATTGGCGTTTTACGACG
AGATTCTCAGGGCTAGATACTTAGATTCTT|TGACAGCACCATTGCACGAGTAGGATACCA
AACACAGTAAATGAGCTAAACATAATTTCG|AGCAGGGCTAGATACTTAGATTCTTAAATT
GGAGTATAGGATGCTCAAAGTCTCCAGGAA|GGGCTAGATACTTAGATTCTTAAATTGGAA
CTTAAATTGGAGTCCTGTCAGGGCTAGATA|GATACTTAGATTCTTAAATTGGCGTTTTAC
AATTGGTAAATTGGGAGGCAGGGCTAGATA|GACAGAAGTGGATGGTCGGCCTGCGTTCTA
GGCGTTTTACGACGCCGACACACACATCAG|TGAGCTAAACATAATTTCGGGATTATAGCC
CCAGGAGACGGGCAACTCAGGGGTCTCAGG|AGTTTCATTGGTCCAAGCGCCATTGAGCCG
ATACTTAGATTCTTAAATTGGTGGAGTATA|TACGACGCCGACACACACATCAGGGCTAGA
TCACTCCAGGAGACGGGCAACTCAGGGGTC|GCTCAAGTTTCATTGGTCCAAGCGCCATTG
CGGGCAACTCAGGGGTCTCAGGATCAACTC|TGGTCCAAGCGCCATTGAGCCGAACTAGAA
ACTTAGATTCTTAAATTGGAATTCTCCCTC|CTAGATACTTAGATTCTTAAATTGGCGCGC
AGACGGGCAACTCAGGGGTCTCAGGATCAA|CATTGGTCCAAGCGCCATTGAGCCGAACTA
GACCGATCGTCGGTGATTCTATACAACCGC|TGAAGTCCCCTAGGGTCATGTCTGCATTAA
AGTGGAACCAACACTCCAAAATCGCAGCAG|GGAGTAGCAGGTGCTGCGGTGGGCAGCATG
GCCGCCATCGACCGATCGTCGGTGATTCTA|TTTTCTGGTTGAAGTCCCCTAGGGTCATGT
AGTCACCCGTGTCGTGGCTCAAGTTTCATT|GATTCTATACAACCGCCACAGCCTCTGAGT
TGCGTTCTAGCCATCCACCGTGTCTAAGTG|TGCGCTGGCGTGAGCATTCACGCCTCGGAG
TGTGTAGATGAGGGTAGCCGCCATCGACCG|TTCAGCATGGACTCCATTTTCTGGTTGAAG
CCATCGCTCAGGGCTAGATACTTAGATTCT|AGACGGGCAACTCAGGGGTCTCAGGATCAA
CTTAAATTGGTGGAGTATAGGATGCTCAAA|CACACACATCAGGGCTAGATACTTAGATTC
CACGAGTAGGATACCATGACAGAAGTGGAT|TAGATTCTTAAATTGGATTGCTAAGGTCCA
TTGCGCTGGCGTGAGCATTCACGCCTCGGA|AGATTCTTAAATTGGTGGAGTATAGGATGC
CTAGATACTTAGATTCTTAAATTGGTAAAT|TGCACGAGTAGGATACCATGACAGAAGTGG
CAGGAAGCCCCCAACGTGACAAGGGGTCCT|TTGGAATTCTCCCTCAACTAGGGCTCCATC
ATGAGCGCTTGCGCTGGCGTGAGCATTCAC|AGATACTTAGATTCTTAAATTGGTGGAGTA
CTCAGGGCTAGATACTTAGATTCTTAAATT|GCAACTCAGGGGTCTCAGGATCAACTCTAT
GGGTAGCCGCCATCGACCGATCGTCGGTGA|CTCCATTTTCTGGTTGAAGTCCCCTAGGGT
AAGAAGGACTCACAGGGCTAGATACTTAGA|AGCTCTCTCGACCGTAACGTATGCTGAACA
CTTACCAGCCAGCGGTGTCTGCAGGGCTAG|TCGCTCAGGGCTAGATACTTAGATTCTTAA
GGGGTCTCAGGATCAACTCTATGAAATAGC|CCATTGAGCCGAACTAGAACTCGTGGGCGC
TTCTTAAATTGGCCCAACACAGTAAATGAG|TCAACTCTATGAAATAGCAGGGCTAGATAC
GAACTAGAACTCGTGGGCGCCTCACGTCCA|GACGAACCTATATCACCATTGCGCTGCGGC
ACCATTGCACGAGTAGGATACCATGACAGA|AGATACTTAGATTCTTAAATTGGATTGCTA
GCATTCACGCCTCGGAGTAGCAGGTGCTGC|GTGGAGTATAGGATGCTCAAAGTCTCCAGG
ATTCACGCCTCGGAGTAGCAGGTGCTGCGG|GGAGTATAGGATGCTCAAAGTCTCCAGGAA
CAAGGGGTCCTTACCAGCCAGCGGTGTCTG|AGGGCTCCATCGCTCAGGGCTAGATACTTA
AATAACGAGTCACCCGTGTCGTGGCTCAAG|CGTCGGTGATTCTATACAACCGCCACAGCC
GAACACGGCCGTTGACAGCACCATTGCACG|TCCACCCCAAGGCAGGGCTAGATACTTAGA
CGTCCACCCCAAGGCAGGGCTAGATACTTA|GCAGAACTGAAGCAGGGCTAGATACTTAGA
CAGGGCTAGATACTTAGATTCTTAAATTGG|TTGGCGTTTTACGACGCCGACACACACATC
ACTTAGATTCTTAAATTGGTGGAGTATAGG|CGACGCCGACACACACATCAGGGCTAGATA
CGCTCCGCTAATACCAGAACCTCAGGGCTA|GGGATTCTTAAATTGGATCGGAAAAGAACA
GCAGGGCTAGATACTTAGATTCTTAAATTG|AGGGCTAGATACTTAGATTCTTAAATTGGA
CCAGCGAATAACGAGTCACCCGTGTCGTGG|ACCGATCGTCGGTGATTCTATACAACCGCC
TTTCGGGATTATAGCCAACCAGGGCTAGAT|AAATTGGGCGATAAGTAACAGAGGACCAGC
ATTCTTAAATTGGGCGATAAGTAACAGAGG|CTTACTGTGTAGATGAGGGTAGCCGCCATC
GCAGCAGAGTGCTAACGTCCACCCCAAGGC|CAGCATGCAGCTTACGCAGAACTGAAGCAG
GAAAAGAACACGGCCGTTGACAGCACCATT|TAACGTCCACCCCAAGGCAGGGCTAGATAC
CTTAGATTCTTAAATTGGCGCGCTCACTCC|AATAACGAGTCACCCGTGTCGTGGCTCAAG
ATCTAAATAGAGAAGCTCTCTCGACCGTAA|TGGTAAATTGGGAGGCAGGGCTAGATACTT
AGGGCTAGATACTTAGATTCTTAAATTGGC|ACTCAGGGGTCTCAGGATCAACTCTATGAA
TAGCAGGGCTAGATACTTAGATTCTTAAAT|GCGCCTCACGTCCAAGCTACCTTACTGTGT
AGGGCTAGATACTTACAGGGCTAGATACTT|CCTGCGTTCTAGCCATCCACCGTGTCTAAG
ACGTCCAAGCTACCTTACTGTGTAGATGAG|CTGCGGCTCTCCTTGGTGTTCAGCATGGAC
TTGGTCCAAGCGCCATTGAGCCGAACTAGA|GTCGCACCTCGAGTTTCCGGCAGACGAACC
CTCTCGACCGTAACGTATGCTGAACAGACA|GGGCTAGATACTTACAGGGCTAGATACTTA
CATGCAGCTTACGCAGAACTGAAGCAGGGC|ACGTGACAAGGGGTCCTTACCAGCCAGCGG
GTCGTGGCTCAAGTTTCATTGGTCCAAGCG|AACCGCCACAGCCTCTGAGTCGCACCTCGA
AGATACTTAGATTCTTAAATTGGCCCAACA|GGGTCTCAGGATCAACTCTATGAAATAGCA
CGAGTCACCCGTGTCGTGGCTCAAGTTTCA|GTGATTCTATACAACCGCCACAGCCTCTGA
AGGCAGGGCTAGATACTTAGATTCTTAAAT|GCAGGGCTAGATACTTAGATTCTTAAATTG
AGGATGCTCAAAGTCTCCAGGAAGCCCCCA|ATACTTAGATTCTTAAATTGGAATTCTCCC
GAGAAGCTCTCTCGACCGTAACGTATGCTG|GGGAGGCAGGGCTAGATACTTACAGGGCTA
AACTAGAACTCGTGGGCGCCTCACGTCCAA|ACGAACCTATATCACCATTGCGCTGCGGCT
TGGAAATTGGGCGTAGCGGCTATCTAAATA|TAGATACTTAGATTCTTAAATTGGTAAATT
TTAAATTGGTAGACAGGGCTAGATACTTAG|AGCATCTAAGCGCCGCTCCGCTAATACCAG
TCCGCTAATACCAGAACCTCAGGGCTAGAT|ATTCTTAAATTGGATCGGAAAAGAACACGG
AAGAACACGGCCGTTGACAGCACCATTGCA|CGTCCACCCCAAGGCAGGGCTAGATACTTA
TCTTAAATTGGTAAATTGGGAGGCAGGGCT|ACCATGACAGAAGTGGATGGTCGGCCTGCG
CATCTAAGCGCCGCTCCGCTAATACCAGAA|ATTCTTAAATTGGGATTCTTAAATTGGATC
CTCGAGTTTCCGGCAGACGAACCTATATCA|AGTGGAGGTCTACTGTGTGCGTATCTCCGC
GTGGAACCAACACTCCAAAATCGCAGCAGA|GAGTAGCAGGTGCTGCGGTGGGCAGCATGC
TAATTTCGGGATTATAGCCAACCAGGGCTA|CTTAAATTGGGCGATAAGTAACAGAGGACC
TACTTAGATTCTTCAGGGCTAGATACTTAG|ATACCAGAACCTCAGGGCTAGATACTTAGA
CCTCGGAGTAGCAGGTGCTGCGGTGGGCAG|AGGATGCTCAAAGTCTCCAGGAAGCCCCCA
TCGGCCTGCGTTCTAGCCATCCACCGTGTC|AGCGCTTGCGCTGGCGTGAGCATTCACGCC
GGTCCAAGCGCCATTGAGCCGAACTAGAAC|CGCACCTCGAGTTTCCGGCAGACGAACCTA
TACTTAGATTCTTAAATTGGTGGAGTATAG|ACGACGCCGACACACACATCAGGGCTAGAT
ATCACCATTGCGCTGCGGCTCTCCTTGGTG|CCGCCAGGGACGATGACTAGTCACATGGGC
GCTGGCGTGAGCATTCACGCCTCGGAGTAG|TCTTAAATTGGTGGAGTATAGGATGCTCAA
AACTCAGGGGTCTCAGGATCAACTCTATGA|CAAGCGCCATTGAGCCGAACTAGAACTCGT
ATTGAGCCGAACTAGAACTCGTGGGCGCCT|TTCCGGCAGACGAACCTATATCACCATTGC
CAAGCTACCTTACTGTGTAGATGAGGGTAG|GCTCTCCTTGGTGTTCAGCATGGACTCCAT
ACTGAAGCAGGGCTAGATACTTAGATTCTT|TACCAGCCAGCGGTGTCTGCAGGGCTAGAT
